Loc PackedFile
Key	Text	Tooltip
cdir_events_dilemma_choice_details_localised_choice_label_shield_ally_region_vik_reg_abberdeonFIRST	Return the Region	true
cdir_events_dilemma_choice_details_localised_choice_label_shield_ally_region_vik_reg_abberdeonSECOND	Keep the Region	true
cdir_events_dilemma_choice_details_localised_choice_label_shield_ally_region_vik_reg_aberffroFIRST	Return the Region	true
cdir_events_dilemma_choice_details_localised_choice_label_shield_ally_region_vik_reg_aberffroSECOND	Keep the Region	true
cdir_events_dilemma_choice_details_localised_choice_label_shield_ally_region_vik_reg_aberteifiFIRST	Return the Region	true
cdir_events_dilemma_choice_details_localised_choice_label_shield_ally_region_vik_reg_aberteifiSECOND	Keep the Region	true
cdir_events_dilemma_choice_details_localised_choice_label_shield_ally_region_vik_reg_achadh_boFIRST	Return the Region	true
cdir_events_dilemma_choice_details_localised_choice_label_shield_ally_region_vik_reg_achadh_boSECOND	Keep the Region	true
cdir_events_dilemma_choice_details_localised_choice_label_shield_ally_region_vik_reg_aebburcurnigFIRST	Return the Region	true
cdir_events_dilemma_choice_details_localised_choice_label_shield_ally_region_vik_reg_aebburcurnigSECOND	Keep the Region	true
cdir_events_dilemma_choice_details_localised_choice_label_shield_ally_region_vik_reg_aelmhamFIRST	Return the Region	true
cdir_events_dilemma_choice_details_localised_choice_label_shield_ally_region_vik_reg_aelmhamSECOND	Keep the Region	true
cdir_events_dilemma_choice_details_localised_choice_label_shield_ally_region_vik_reg_aethelingaegFIRST	Return the Region	true
cdir_events_dilemma_choice_details_localised_choice_label_shield_ally_region_vik_reg_aethelingaegSECOND	Keep the Region	true
cdir_events_dilemma_choice_details_localised_choice_label_shield_ally_region_vik_reg_airchardanFIRST	Return the Region	true
cdir_events_dilemma_choice_details_localised_choice_label_shield_ally_region_vik_reg_airchardanSECOND	Keep the Region	true
cdir_events_dilemma_choice_details_localised_choice_label_shield_ally_region_vik_reg_alclytFIRST	Return the Region	true
cdir_events_dilemma_choice_details_localised_choice_label_shield_ally_region_vik_reg_alclytSECOND	Keep the Region	true
cdir_events_dilemma_choice_details_localised_choice_label_shield_ally_region_vik_reg_alt_clutFIRST	Return the Region	true
cdir_events_dilemma_choice_details_localised_choice_label_shield_ally_region_vik_reg_alt_clutSECOND	Keep the Region	true
cdir_events_dilemma_choice_details_localised_choice_label_shield_ally_region_vik_reg_an_tinbhear_morFIRST	Return the Region	true
cdir_events_dilemma_choice_details_localised_choice_label_shield_ally_region_vik_reg_an_tinbhear_morSECOND	Keep the Region	true
cdir_events_dilemma_choice_details_localised_choice_label_shield_ally_region_vik_reg_aporcrosanFIRST	Return the Region	true
cdir_events_dilemma_choice_details_localised_choice_label_shield_ally_region_vik_reg_aporcrosanSECOND	Keep the Region	true
cdir_events_dilemma_choice_details_localised_choice_label_shield_ally_region_vik_reg_ard_fertFIRST	Return the Region	true
cdir_events_dilemma_choice_details_localised_choice_label_shield_ally_region_vik_reg_ard_fertSECOND	Keep the Region	true
cdir_events_dilemma_choice_details_localised_choice_label_shield_ally_region_vik_reg_ard_machaFIRST	Return the Region	true
cdir_events_dilemma_choice_details_localised_choice_label_shield_ally_region_vik_reg_ard_machaSECOND	Keep the Region	true
cdir_events_dilemma_choice_details_localised_choice_label_shield_ally_region_vik_reg_ard_morFIRST	Return the Region	true
cdir_events_dilemma_choice_details_localised_choice_label_shield_ally_region_vik_reg_ard_morSECOND	Keep the Region	true
cdir_events_dilemma_choice_details_localised_choice_label_shield_ally_region_vik_reg_ard_srathaFIRST	Return the Region	true
cdir_events_dilemma_choice_details_localised_choice_label_shield_ally_region_vik_reg_ard_srathaSECOND	Keep the Region	true
cdir_events_dilemma_choice_details_localised_choice_label_shield_ally_region_vik_reg_ardachFIRST	Return the Region	true
cdir_events_dilemma_choice_details_localised_choice_label_shield_ally_region_vik_reg_ardachSECOND	Keep the Region	true
cdir_events_dilemma_choice_details_localised_choice_label_shield_ally_region_vik_reg_axanbrycgFIRST	Return the Region	true
cdir_events_dilemma_choice_details_localised_choice_label_shield_ally_region_vik_reg_axanbrycgSECOND	Keep the Region	true
cdir_events_dilemma_choice_details_localised_choice_label_shield_ally_region_vik_reg_ballaFIRST	Return the Region	true
cdir_events_dilemma_choice_details_localised_choice_label_shield_ally_region_vik_reg_ballaSECOND	Keep the Region	true
cdir_events_dilemma_choice_details_localised_choice_label_shield_ally_region_vik_reg_basengasFIRST	Return the Region	true
cdir_events_dilemma_choice_details_localised_choice_label_shield_ally_region_vik_reg_basengasSECOND	Keep the Region	true
cdir_events_dilemma_choice_details_localised_choice_label_shield_ally_region_vik_reg_bathanceasterFIRST	Return the Region	true
cdir_events_dilemma_choice_details_localised_choice_label_shield_ally_region_vik_reg_bathanceasterSECOND	Keep the Region	true
cdir_events_dilemma_choice_details_localised_choice_label_shield_ally_region_vik_reg_bebbanburgFIRST	Return the Region	true
cdir_events_dilemma_choice_details_localised_choice_label_shield_ally_region_vik_reg_bebbanburgSECOND	Keep the Region	true
cdir_events_dilemma_choice_details_localised_choice_label_shield_ally_region_vik_reg_bedanfordFIRST	Return the Region	true
cdir_events_dilemma_choice_details_localised_choice_label_shield_ally_region_vik_reg_bedanfordSECOND	Keep the Region	true
cdir_events_dilemma_choice_details_localised_choice_label_shield_ally_region_vik_reg_beoferlicFIRST	Return the Region	true
cdir_events_dilemma_choice_details_localised_choice_label_shield_ally_region_vik_reg_beoferlicSECOND	Keep the Region	true
cdir_events_dilemma_choice_details_localised_choice_label_shield_ally_region_vik_reg_blasconaFIRST	Return the Region	true
cdir_events_dilemma_choice_details_localised_choice_label_shield_ally_region_vik_reg_blasconaSECOND	Keep the Region	true
cdir_events_dilemma_choice_details_localised_choice_label_shield_ally_region_vik_reg_bodmineFIRST	Return the Region	true
cdir_events_dilemma_choice_details_localised_choice_label_shield_ally_region_vik_reg_bodmineSECOND	Keep the Region	true
cdir_events_dilemma_choice_details_localised_choice_label_shield_ally_region_vik_reg_bornaisFIRST	Return the Region	true
cdir_events_dilemma_choice_details_localised_choice_label_shield_ally_region_vik_reg_bornaisSECOND	Keep the Region	true
cdir_events_dilemma_choice_details_localised_choice_label_shield_ally_region_vik_reg_brechinFIRST	Return the Region	true
cdir_events_dilemma_choice_details_localised_choice_label_shield_ally_region_vik_reg_brechinSECOND	Keep the Region	true
cdir_events_dilemma_choice_details_localised_choice_label_shield_ally_region_vik_reg_brideportFIRST	Return the Region	true
cdir_events_dilemma_choice_details_localised_choice_label_shield_ally_region_vik_reg_brideportSECOND	Keep the Region	true
cdir_events_dilemma_choice_details_localised_choice_label_shield_ally_region_vik_reg_brugFIRST	Return the Region	true
cdir_events_dilemma_choice_details_localised_choice_label_shield_ally_region_vik_reg_brugSECOND	Keep the Region	true
cdir_events_dilemma_choice_details_localised_choice_label_shield_ally_region_vik_reg_buccingahammFIRST	Return the Region	true
cdir_events_dilemma_choice_details_localised_choice_label_shield_ally_region_vik_reg_buccingahammSECOND	Keep the Region	true
cdir_events_dilemma_choice_details_localised_choice_label_shield_ally_region_vik_reg_cair_gwentFIRST	Return the Region	true
cdir_events_dilemma_choice_details_localised_choice_label_shield_ally_region_vik_reg_cair_gwentSECOND	Keep the Region	true
cdir_events_dilemma_choice_details_localised_choice_label_shield_ally_region_vik_reg_cair_mirddinFIRST	Return the Region	true
cdir_events_dilemma_choice_details_localised_choice_label_shield_ally_region_vik_reg_cair_mirddinSECOND	Keep the Region	true
cdir_events_dilemma_choice_details_localised_choice_label_shield_ally_region_vik_reg_cair_segeintFIRST	Return the Region	true
cdir_events_dilemma_choice_details_localised_choice_label_shield_ally_region_vik_reg_cair_segeintSECOND	Keep the Region	true
cdir_events_dilemma_choice_details_localised_choice_label_shield_ally_region_vik_reg_cairlinnFIRST	Return the Region	true
cdir_events_dilemma_choice_details_localised_choice_label_shield_ally_region_vik_reg_cairlinnSECOND	Keep the Region	true
cdir_events_dilemma_choice_details_localised_choice_label_shield_ally_region_vik_reg_caisilFIRST	Return the Region	true
cdir_events_dilemma_choice_details_localised_choice_label_shield_ally_region_vik_reg_caisilSECOND	Keep the Region	true
cdir_events_dilemma_choice_details_localised_choice_label_shield_ally_region_vik_reg_cantwaraburgFIRST	Return the Region	true
cdir_events_dilemma_choice_details_localised_choice_label_shield_ally_region_vik_reg_cantwaraburgSECOND	Keep the Region	true
cdir_events_dilemma_choice_details_localised_choice_label_shield_ally_region_vik_reg_carleolFIRST	Return the Region	true
cdir_events_dilemma_choice_details_localised_choice_label_shield_ally_region_vik_reg_carleolSECOND	Keep the Region	true
cdir_events_dilemma_choice_details_localised_choice_label_shield_ally_region_vik_reg_casteltounFIRST	Return the Region	true
cdir_events_dilemma_choice_details_localised_choice_label_shield_ally_region_vik_reg_casteltounSECOND	Keep the Region	true
cdir_events_dilemma_choice_details_localised_choice_label_shield_ally_region_vik_reg_cathair_commainFIRST	Return the Region	true
cdir_events_dilemma_choice_details_localised_choice_label_shield_ally_region_vik_reg_cathair_commainSECOND	Keep the Region	true
cdir_events_dilemma_choice_details_localised_choice_label_shield_ally_region_vik_reg_cathair_domnaillFIRST	Return the Region	true
cdir_events_dilemma_choice_details_localised_choice_label_shield_ally_region_vik_reg_cathair_domnaillSECOND	Keep the Region	true
cdir_events_dilemma_choice_details_localised_choice_label_shield_ally_region_vik_reg_ceasterFIRST	Return the Region	true
cdir_events_dilemma_choice_details_localised_choice_label_shield_ally_region_vik_reg_ceasterSECOND	Keep the Region	true
cdir_events_dilemma_choice_details_localised_choice_label_shield_ally_region_vik_reg_cell_alaidFIRST	Return the Region	true
cdir_events_dilemma_choice_details_localised_choice_label_shield_ally_region_vik_reg_cell_alaidSECOND	Keep the Region	true
cdir_events_dilemma_choice_details_localised_choice_label_shield_ally_region_vik_reg_cell_cainningFIRST	Return the Region	true
cdir_events_dilemma_choice_details_localised_choice_label_shield_ally_region_vik_reg_cell_cainningSECOND	Keep the Region	true
cdir_events_dilemma_choice_details_localised_choice_label_shield_ally_region_vik_reg_cell_daltainFIRST	Return the Region	true
cdir_events_dilemma_choice_details_localised_choice_label_shield_ally_region_vik_reg_cell_daltainSECOND	Keep the Region	true
cdir_events_dilemma_choice_details_localised_choice_label_shield_ally_region_vik_reg_cell_maic_aedaFIRST	Return the Region	true
cdir_events_dilemma_choice_details_localised_choice_label_shield_ally_region_vik_reg_cell_maic_aedaSECOND	Keep the Region	true
cdir_events_dilemma_choice_details_localised_choice_label_shield_ally_region_vik_reg_cell_morFIRST	Return the Region	true
cdir_events_dilemma_choice_details_localised_choice_label_shield_ally_region_vik_reg_cell_morSECOND	Keep the Region	true
cdir_events_dilemma_choice_details_localised_choice_label_shield_ally_region_vik_reg_celmeresfortFIRST	Return the Region	true
cdir_events_dilemma_choice_details_localised_choice_label_shield_ally_region_vik_reg_celmeresfortSECOND	Keep the Region	true
cdir_events_dilemma_choice_details_localised_choice_label_shield_ally_region_vik_reg_cenannasFIRST	Return the Region	true
cdir_events_dilemma_choice_details_localised_choice_label_shield_ally_region_vik_reg_cenannasSECOND	Keep the Region	true
cdir_events_dilemma_choice_details_localised_choice_label_shield_ally_region_vik_reg_cenn_rigmonidFIRST	Return the Region	true
cdir_events_dilemma_choice_details_localised_choice_label_shield_ally_region_vik_reg_cenn_rigmonidSECOND	Keep the Region	true
cdir_events_dilemma_choice_details_localised_choice_label_shield_ally_region_vik_reg_cetrethaFIRST	Return the Region	true
cdir_events_dilemma_choice_details_localised_choice_label_shield_ally_region_vik_reg_cetrethaSECOND	Keep the Region	true
cdir_events_dilemma_choice_details_localised_choice_label_shield_ally_region_vik_reg_cherchebiFIRST	Return the Region	true
cdir_events_dilemma_choice_details_localised_choice_label_shield_ally_region_vik_reg_cherchebiSECOND	Keep the Region	true
cdir_events_dilemma_choice_details_localised_choice_label_shield_ally_region_vik_reg_cippanhammFIRST	Return the Region	true
cdir_events_dilemma_choice_details_localised_choice_label_shield_ally_region_vik_reg_cippanhammSECOND	Keep the Region	true
cdir_events_dilemma_choice_details_localised_choice_label_shield_ally_region_vik_reg_cirenceasterFIRST	Return the Region	true
cdir_events_dilemma_choice_details_localised_choice_label_shield_ally_region_vik_reg_cirenceasterSECOND	Keep the Region	true
cdir_events_dilemma_choice_details_localised_choice_label_shield_ally_region_vik_reg_cissanbyrigFIRST	Return the Region	true
cdir_events_dilemma_choice_details_localised_choice_label_shield_ally_region_vik_reg_cissanbyrigSECOND	Keep the Region	true
cdir_events_dilemma_choice_details_localised_choice_label_shield_ally_region_vik_reg_clocherFIRST	Return the Region	true
cdir_events_dilemma_choice_details_localised_choice_label_shield_ally_region_vik_reg_clocherSECOND	Keep the Region	true
cdir_events_dilemma_choice_details_localised_choice_label_shield_ally_region_vik_reg_cluain_eoaisFIRST	Return the Region	true
cdir_events_dilemma_choice_details_localised_choice_label_shield_ally_region_vik_reg_cluain_eoaisSECOND	Keep the Region	true
cdir_events_dilemma_choice_details_localised_choice_label_shield_ally_region_vik_reg_cluain_irairdFIRST	Return the Region	true
cdir_events_dilemma_choice_details_localised_choice_label_shield_ally_region_vik_reg_cluain_irairdSECOND	Keep the Region	true
cdir_events_dilemma_choice_details_localised_choice_label_shield_ally_region_vik_reg_cluain_mac_noisFIRST	Return the Region	true
cdir_events_dilemma_choice_details_localised_choice_label_shield_ally_region_vik_reg_cluain_mac_noisSECOND	Keep the Region	true
cdir_events_dilemma_choice_details_localised_choice_label_shield_ally_region_vik_reg_cluain_morFIRST	Return the Region	true
cdir_events_dilemma_choice_details_localised_choice_label_shield_ally_region_vik_reg_cluain_morSECOND	Keep the Region	true
cdir_events_dilemma_choice_details_localised_choice_label_shield_ally_region_vik_reg_cluainFIRST	Return the Region	true
cdir_events_dilemma_choice_details_localised_choice_label_shield_ally_region_vik_reg_cluainSECOND	Keep the Region	true
cdir_events_dilemma_choice_details_localised_choice_label_shield_ally_region_vik_reg_cnodbaFIRST	Return the Region	true
cdir_events_dilemma_choice_details_localised_choice_label_shield_ally_region_vik_reg_cnodbaSECOND	Keep the Region	true
cdir_events_dilemma_choice_details_localised_choice_label_shield_ally_region_vik_reg_coinnireFIRST	Return the Region	true
cdir_events_dilemma_choice_details_localised_choice_label_shield_ally_region_vik_reg_coinnireSECOND	Keep the Region	true
cdir_events_dilemma_choice_details_localised_choice_label_shield_ally_region_vik_reg_coldingahamFIRST	Return the Region	true
cdir_events_dilemma_choice_details_localised_choice_label_shield_ally_region_vik_reg_coldingahamSECOND	Keep the Region	true
cdir_events_dilemma_choice_details_localised_choice_label_shield_ally_region_vik_reg_colneceasterFIRST	Return the Region	true
cdir_events_dilemma_choice_details_localised_choice_label_shield_ally_region_vik_reg_colneceasterSECOND	Keep the Region	true
cdir_events_dilemma_choice_details_localised_choice_label_shield_ally_region_vik_reg_corcachFIRST	Return the Region	true
cdir_events_dilemma_choice_details_localised_choice_label_shield_ally_region_vik_reg_corcachSECOND	Keep the Region	true
cdir_events_dilemma_choice_details_localised_choice_label_shield_ally_region_vik_reg_cridiatuneFIRST	Return the Region	true
cdir_events_dilemma_choice_details_localised_choice_label_shield_ally_region_vik_reg_cridiatuneSECOND	Keep the Region	true
cdir_events_dilemma_choice_details_localised_choice_label_shield_ally_region_vik_reg_dacorFIRST	Return the Region	true
cdir_events_dilemma_choice_details_localised_choice_label_shield_ally_region_vik_reg_dacorSECOND	Keep the Region	true
cdir_events_dilemma_choice_details_localised_choice_label_shield_ally_region_vik_reg_dearFIRST	Return the Region	true
cdir_events_dilemma_choice_details_localised_choice_label_shield_ally_region_vik_reg_dearSECOND	Keep the Region	true
cdir_events_dilemma_choice_details_localised_choice_label_shield_ally_region_vik_reg_deorabyFIRST	Return the Region	true
cdir_events_dilemma_choice_details_localised_choice_label_shield_ally_region_vik_reg_deorabySECOND	Keep the Region	true
cdir_events_dilemma_choice_details_localised_choice_label_shield_ally_region_vik_reg_din_prysFIRST	Return the Region	true
cdir_events_dilemma_choice_details_localised_choice_label_shield_ally_region_vik_reg_din_prysSECOND	Keep the Region	true
cdir_events_dilemma_choice_details_localised_choice_label_shield_ally_region_vik_reg_dinas_powisFIRST	Return the Region	true
cdir_events_dilemma_choice_details_localised_choice_label_shield_ally_region_vik_reg_dinas_powisSECOND	Keep the Region	true
cdir_events_dilemma_choice_details_localised_choice_label_shield_ally_region_vik_reg_dinefwrFIRST	Return the Region	true
cdir_events_dilemma_choice_details_localised_choice_label_shield_ally_region_vik_reg_dinefwrSECOND	Keep the Region	true
cdir_events_dilemma_choice_details_localised_choice_label_shield_ally_region_vik_reg_dofereFIRST	Return the Region	true
cdir_events_dilemma_choice_details_localised_choice_label_shield_ally_region_vik_reg_dofereSECOND	Keep the Region	true
cdir_events_dilemma_choice_details_localised_choice_label_shield_ally_region_vik_reg_domucFIRST	Return the Region	true
cdir_events_dilemma_choice_details_localised_choice_label_shield_ally_region_vik_reg_domucSECOND	Keep the Region	true
cdir_events_dilemma_choice_details_localised_choice_label_shield_ally_region_vik_reg_doneceasterFIRST	Return the Region	true
cdir_events_dilemma_choice_details_localised_choice_label_shield_ally_region_vik_reg_doneceasterSECOND	Keep the Region	true
cdir_events_dilemma_choice_details_localised_choice_label_shield_ally_region_vik_reg_doreceasterFIRST	Return the Region	true
cdir_events_dilemma_choice_details_localised_choice_label_shield_ally_region_vik_reg_doreceasterSECOND	Keep the Region	true
cdir_events_dilemma_choice_details_localised_choice_label_shield_ally_region_vik_reg_dorFIRST	Return the Region	true
cdir_events_dilemma_choice_details_localised_choice_label_shield_ally_region_vik_reg_dorSECOND	Keep the Region	true
cdir_events_dilemma_choice_details_localised_choice_label_shield_ally_region_vik_reg_draytonFIRST	Return the Region	true
cdir_events_dilemma_choice_details_localised_choice_label_shield_ally_region_vik_reg_draytonSECOND	Keep the Region	true
cdir_events_dilemma_choice_details_localised_choice_label_shield_ally_region_vik_reg_druim_collachairFIRST	Return the Region	true
cdir_events_dilemma_choice_details_localised_choice_label_shield_ally_region_vik_reg_druim_collachairSECOND	Keep the Region	true
cdir_events_dilemma_choice_details_localised_choice_label_shield_ally_region_vik_reg_druim_da_ethiarFIRST	Return the Region	true
cdir_events_dilemma_choice_details_localised_choice_label_shield_ally_region_vik_reg_druim_da_ethiarSECOND	Keep the Region	true
cdir_events_dilemma_choice_details_localised_choice_label_shield_ally_region_vik_reg_dugannuFIRST	Return the Region	true
cdir_events_dilemma_choice_details_localised_choice_label_shield_ally_region_vik_reg_dugannuSECOND	Keep the Region	true
cdir_events_dilemma_choice_details_localised_choice_label_shield_ally_region_vik_reg_dun_aberteFIRST	Return the Region	true
cdir_events_dilemma_choice_details_localised_choice_label_shield_ally_region_vik_reg_dun_aberteSECOND	Keep the Region	true
cdir_events_dilemma_choice_details_localised_choice_label_shield_ally_region_vik_reg_dun_attFIRST	Return the Region	true
cdir_events_dilemma_choice_details_localised_choice_label_shield_ally_region_vik_reg_dun_attSECOND	Keep the Region	true
cdir_events_dilemma_choice_details_localised_choice_label_shield_ally_region_vik_reg_dun_beccanFIRST	Return the Region	true
cdir_events_dilemma_choice_details_localised_choice_label_shield_ally_region_vik_reg_dun_beccanSECOND	Keep the Region	true
cdir_events_dilemma_choice_details_localised_choice_label_shield_ally_region_vik_reg_dun_blannFIRST	Return the Region	true
cdir_events_dilemma_choice_details_localised_choice_label_shield_ally_region_vik_reg_dun_blannSECOND	Keep the Region	true
cdir_events_dilemma_choice_details_localised_choice_label_shield_ally_region_vik_reg_dun_caildenFIRST	Return the Region	true
cdir_events_dilemma_choice_details_localised_choice_label_shield_ally_region_vik_reg_dun_caildenSECOND	Keep the Region	true
cdir_events_dilemma_choice_details_localised_choice_label_shield_ally_region_vik_reg_dun_domnaillFIRST	Return the Region	true
cdir_events_dilemma_choice_details_localised_choice_label_shield_ally_region_vik_reg_dun_domnaillSECOND	Keep the Region	true
cdir_events_dilemma_choice_details_localised_choice_label_shield_ally_region_vik_reg_dun_duirnFIRST	Return the Region	true
cdir_events_dilemma_choice_details_localised_choice_label_shield_ally_region_vik_reg_dun_duirnSECOND	Keep the Region	true
cdir_events_dilemma_choice_details_localised_choice_label_shield_ally_region_vik_reg_dun_eachainnFIRST	Return the Region	true
cdir_events_dilemma_choice_details_localised_choice_label_shield_ally_region_vik_reg_dun_eachainnSECOND	Keep the Region	true
cdir_events_dilemma_choice_details_localised_choice_label_shield_ally_region_vik_reg_dun_foitherFIRST	Return the Region	true
cdir_events_dilemma_choice_details_localised_choice_label_shield_ally_region_vik_reg_dun_foitherSECOND	Keep the Region	true
cdir_events_dilemma_choice_details_localised_choice_label_shield_ally_region_vik_reg_dun_na_ngallFIRST	Return the Region	true
cdir_events_dilemma_choice_details_localised_choice_label_shield_ally_region_vik_reg_dun_na_ngallSECOND	Keep the Region	true
cdir_events_dilemma_choice_details_localised_choice_label_shield_ally_region_vik_reg_dun_nechtainFIRST	Return the Region	true
cdir_events_dilemma_choice_details_localised_choice_label_shield_ally_region_vik_reg_dun_nechtainSECOND	Keep the Region	true
cdir_events_dilemma_choice_details_localised_choice_label_shield_ally_region_vik_reg_dun_ollaigFIRST	Return the Region	true
cdir_events_dilemma_choice_details_localised_choice_label_shield_ally_region_vik_reg_dun_ollaigSECOND	Keep the Region	true
cdir_events_dilemma_choice_details_localised_choice_label_shield_ally_region_vik_reg_dun_patraicFIRST	Return the Region	true
cdir_events_dilemma_choice_details_localised_choice_label_shield_ally_region_vik_reg_dun_patraicSECOND	Keep the Region	true
cdir_events_dilemma_choice_details_localised_choice_label_shield_ally_region_vik_reg_dun_sebuirgiFIRST	Return the Region	true
cdir_events_dilemma_choice_details_localised_choice_label_shield_ally_region_vik_reg_dun_sebuirgiSECOND	Keep the Region	true
cdir_events_dilemma_choice_details_localised_choice_label_shield_ally_region_vik_reg_dunholmFIRST	Return the Region	true
cdir_events_dilemma_choice_details_localised_choice_label_shield_ally_region_vik_reg_dunholmSECOND	Keep the Region	true
cdir_events_dilemma_choice_details_localised_choice_label_shield_ally_region_vik_reg_dyflinFIRST	Return the Region	true
cdir_events_dilemma_choice_details_localised_choice_label_shield_ally_region_vik_reg_dyflinSECOND	Keep the Region	true
cdir_events_dilemma_choice_details_localised_choice_label_shield_ally_region_vik_reg_dynbaerFIRST	Return the Region	true
cdir_events_dilemma_choice_details_localised_choice_label_shield_ally_region_vik_reg_dynbaerSECOND	Keep the Region	true
cdir_events_dilemma_choice_details_localised_choice_label_shield_ally_region_vik_reg_earmuthaFIRST	Return the Region	true
cdir_events_dilemma_choice_details_localised_choice_label_shield_ally_region_vik_reg_earmuthaSECOND	Keep the Region	true
cdir_events_dilemma_choice_details_localised_choice_label_shield_ally_region_vik_reg_ebbeshamFIRST	Return the Region	true
cdir_events_dilemma_choice_details_localised_choice_label_shield_ally_region_vik_reg_ebbeshamSECOND	Keep the Region	true
cdir_events_dilemma_choice_details_localised_choice_label_shield_ally_region_vik_reg_eidenburgFIRST	Return the Region	true
cdir_events_dilemma_choice_details_localised_choice_label_shield_ally_region_vik_reg_eidenburgSECOND	Keep the Region	true
cdir_events_dilemma_choice_details_localised_choice_label_shield_ally_region_vik_reg_eligFIRST	Return the Region	true
cdir_events_dilemma_choice_details_localised_choice_label_shield_ally_region_vik_reg_eligSECOND	Keep the Region	true
cdir_events_dilemma_choice_details_localised_choice_label_shield_ally_region_vik_reg_eoferwicFIRST	Return the Region	true
cdir_events_dilemma_choice_details_localised_choice_label_shield_ally_region_vik_reg_eoferwicSECOND	Keep the Region	true
cdir_events_dilemma_choice_details_localised_choice_label_shield_ally_region_vik_reg_eofeshamFIRST	Return the Region	true
cdir_events_dilemma_choice_details_localised_choice_label_shield_ally_region_vik_reg_eofeshamSECOND	Keep the Region	true
cdir_events_dilemma_choice_details_localised_choice_label_shield_ally_region_vik_reg_ethandunFIRST	Return the Region	true
cdir_events_dilemma_choice_details_localised_choice_label_shield_ally_region_vik_reg_ethandunSECOND	Keep the Region	true
cdir_events_dilemma_choice_details_localised_choice_label_shield_ally_region_vik_reg_exanceasterFIRST	Return the Region	true
cdir_events_dilemma_choice_details_localised_choice_label_shield_ally_region_vik_reg_exanceasterSECOND	Keep the Region	true
cdir_events_dilemma_choice_details_localised_choice_label_shield_ally_region_vik_reg_fernaFIRST	Return the Region	true
cdir_events_dilemma_choice_details_localised_choice_label_shield_ally_region_vik_reg_fernaSECOND	Keep the Region	true
cdir_events_dilemma_choice_details_localised_choice_label_shield_ally_region_vik_reg_flichesburgFIRST	Return the Region	true
cdir_events_dilemma_choice_details_localised_choice_label_shield_ally_region_vik_reg_flichesburgSECOND	Keep the Region	true
cdir_events_dilemma_choice_details_localised_choice_label_shield_ally_region_vik_reg_foraisFIRST	Return the Region	true
cdir_events_dilemma_choice_details_localised_choice_label_shield_ally_region_vik_reg_foraisSECOND	Keep the Region	true
cdir_events_dilemma_choice_details_localised_choice_label_shield_ally_region_vik_reg_gipeswicFIRST	Return the Region	true
cdir_events_dilemma_choice_details_localised_choice_label_shield_ally_region_vik_reg_gipeswicSECOND	Keep the Region	true
cdir_events_dilemma_choice_details_localised_choice_label_shield_ally_region_vik_reg_glastingburiFIRST	Return the Region	true
cdir_events_dilemma_choice_details_localised_choice_label_shield_ally_region_vik_reg_glastingburiSECOND	Keep the Region	true
cdir_events_dilemma_choice_details_localised_choice_label_shield_ally_region_vik_reg_gleann_da_lochFIRST	Return the Region	true
cdir_events_dilemma_choice_details_localised_choice_label_shield_ally_region_vik_reg_gleann_da_lochSECOND	Keep the Region	true
cdir_events_dilemma_choice_details_localised_choice_label_shield_ally_region_vik_reg_gleawceasterFIRST	Return the Region	true
cdir_events_dilemma_choice_details_localised_choice_label_shield_ally_region_vik_reg_gleawceasterSECOND	Keep the Region	true
cdir_events_dilemma_choice_details_localised_choice_label_shield_ally_region_vik_reg_grantabrycgFIRST	Return the Region	true
cdir_events_dilemma_choice_details_localised_choice_label_shield_ally_region_vik_reg_grantabrycgSECOND	Keep the Region	true
cdir_events_dilemma_choice_details_localised_choice_label_shield_ally_region_vik_reg_grianan_aileachFIRST	Return the Region	true
cdir_events_dilemma_choice_details_localised_choice_label_shield_ally_region_vik_reg_grianan_aileachSECOND	Keep the Region	true
cdir_events_dilemma_choice_details_localised_choice_label_shield_ally_region_vik_reg_guldefordFIRST	Return the Region	true
cdir_events_dilemma_choice_details_localised_choice_label_shield_ally_region_vik_reg_guldefordSECOND	Keep the Region	true
cdir_events_dilemma_choice_details_localised_choice_label_shield_ally_region_vik_reg_guvanFIRST	Return the Region	true
cdir_events_dilemma_choice_details_localised_choice_label_shield_ally_region_vik_reg_guvanSECOND	Keep the Region	true
cdir_events_dilemma_choice_details_localised_choice_label_shield_ally_region_vik_reg_gyruumFIRST	Return the Region	true
cdir_events_dilemma_choice_details_localised_choice_label_shield_ally_region_vik_reg_gyruumSECOND	Keep the Region	true
cdir_events_dilemma_choice_details_localised_choice_label_shield_ally_region_vik_reg_haestingasFIRST	Return the Region	true
cdir_events_dilemma_choice_details_localised_choice_label_shield_ally_region_vik_reg_haestingasSECOND	Keep the Region	true
cdir_events_dilemma_choice_details_localised_choice_label_shield_ally_region_vik_reg_hagustaldesFIRST	Return the Region	true
cdir_events_dilemma_choice_details_localised_choice_label_shield_ally_region_vik_reg_hagustaldesSECOND	Keep the Region	true
cdir_events_dilemma_choice_details_localised_choice_label_shield_ally_region_vik_reg_haverfordiaFIRST	Return the Region	true
cdir_events_dilemma_choice_details_localised_choice_label_shield_ally_region_vik_reg_haverfordiaSECOND	Keep the Region	true
cdir_events_dilemma_choice_details_localised_choice_label_shield_ally_region_vik_reg_herefordFIRST	Return the Region	true
cdir_events_dilemma_choice_details_localised_choice_label_shield_ally_region_vik_reg_herefordSECOND	Keep the Region	true
cdir_events_dilemma_choice_details_localised_choice_label_shield_ally_region_vik_reg_herutfordFIRST	Return the Region	true
cdir_events_dilemma_choice_details_localised_choice_label_shield_ally_region_vik_reg_herutfordSECOND	Keep the Region	true
cdir_events_dilemma_choice_details_localised_choice_label_shield_ally_region_vik_reg_heslertonFIRST	Return the Region	true
cdir_events_dilemma_choice_details_localised_choice_label_shield_ally_region_vik_reg_heslertonSECOND	Keep the Region	true
cdir_events_dilemma_choice_details_localised_choice_label_shield_ally_region_vik_reg_hlymrekrFIRST	Return the Region	true
cdir_events_dilemma_choice_details_localised_choice_label_shield_ally_region_vik_reg_hlymrekrSECOND	Keep the Region	true
cdir_events_dilemma_choice_details_localised_choice_label_shield_ally_region_vik_reg_hripumFIRST	Return the Region	true
cdir_events_dilemma_choice_details_localised_choice_label_shield_ally_region_vik_reg_hripumSECOND	Keep the Region	true
cdir_events_dilemma_choice_details_localised_choice_label_shield_ally_region_vik_reg_huntandunFIRST	Return the Region	true
cdir_events_dilemma_choice_details_localised_choice_label_shield_ally_region_vik_reg_huntandunSECOND	Keep the Region	true
cdir_events_dilemma_choice_details_localised_choice_label_shield_ally_region_vik_reg_hwitan_aerneFIRST	Return the Region	true
cdir_events_dilemma_choice_details_localised_choice_label_shield_ally_region_vik_reg_hwitan_aerneSECOND	Keep the Region	true
cdir_events_dilemma_choice_details_localised_choice_label_shield_ally_region_vik_reg_imblech_ibairFIRST	Return the Region	true
cdir_events_dilemma_choice_details_localised_choice_label_shield_ally_region_vik_reg_imblech_ibairSECOND	Keep the Region	true
cdir_events_dilemma_choice_details_localised_choice_label_shield_ally_region_vik_reg_inber_niseFIRST	Return the Region	true
cdir_events_dilemma_choice_details_localised_choice_label_shield_ally_region_vik_reg_inber_niseSECOND	Keep the Region	true
cdir_events_dilemma_choice_details_localised_choice_label_shield_ally_region_vik_reg_inis_cathaighFIRST	Return the Region	true
cdir_events_dilemma_choice_details_localised_choice_label_shield_ally_region_vik_reg_inis_cathaighSECOND	Keep the Region	true
cdir_events_dilemma_choice_details_localised_choice_label_shield_ally_region_vik_reg_inis_faithlennFIRST	Return the Region	true
cdir_events_dilemma_choice_details_localised_choice_label_shield_ally_region_vik_reg_inis_faithlennSECOND	Keep the Region	true
cdir_events_dilemma_choice_details_localised_choice_label_shield_ally_region_vik_reg_inis_patraicFIRST	Return the Region	true
cdir_events_dilemma_choice_details_localised_choice_label_shield_ally_region_vik_reg_inis_patraicSECOND	Keep the Region	true
cdir_events_dilemma_choice_details_localised_choice_label_shield_ally_region_vik_reg_iouaFIRST	Return the Region	true
cdir_events_dilemma_choice_details_localised_choice_label_shield_ally_region_vik_reg_iouaSECOND	Keep the Region	true
cdir_events_dilemma_choice_details_localised_choice_label_shield_ally_region_vik_reg_laeweFIRST	Return the Region	true
cdir_events_dilemma_choice_details_localised_choice_label_shield_ally_region_vik_reg_laeweSECOND	Keep the Region	true
cdir_events_dilemma_choice_details_localised_choice_label_shield_ally_region_vik_reg_lann_afanFIRST	Return the Region	true
cdir_events_dilemma_choice_details_localised_choice_label_shield_ally_region_vik_reg_lann_afanSECOND	Keep the Region	true
cdir_events_dilemma_choice_details_localised_choice_label_shield_ally_region_vik_reg_lann_corsFIRST	Return the Region	true
cdir_events_dilemma_choice_details_localised_choice_label_shield_ally_region_vik_reg_lann_corsSECOND	Keep the Region	true
cdir_events_dilemma_choice_details_localised_choice_label_shield_ally_region_vik_reg_lann_dewiFIRST	Return the Region	true
cdir_events_dilemma_choice_details_localised_choice_label_shield_ally_region_vik_reg_lann_dewiSECOND	Keep the Region	true
cdir_events_dilemma_choice_details_localised_choice_label_shield_ally_region_vik_reg_lann_idloesFIRST	Return the Region	true
cdir_events_dilemma_choice_details_localised_choice_label_shield_ally_region_vik_reg_lann_idloesSECOND	Keep the Region	true
cdir_events_dilemma_choice_details_localised_choice_label_shield_ally_region_vik_reg_lann_ildutFIRST	Return the Region	true
cdir_events_dilemma_choice_details_localised_choice_label_shield_ally_region_vik_reg_lann_ildutSECOND	Keep the Region	true
cdir_events_dilemma_choice_details_localised_choice_label_shield_ally_region_vik_reg_lann_padarnFIRST	Return the Region	true
cdir_events_dilemma_choice_details_localised_choice_label_shield_ally_region_vik_reg_lann_padarnSECOND	Keep the Region	true
cdir_events_dilemma_choice_details_localised_choice_label_shield_ally_region_vik_reg_latharnaFIRST	Return the Region	true
cdir_events_dilemma_choice_details_localised_choice_label_shield_ally_region_vik_reg_latharnaSECOND	Keep the Region	true
cdir_events_dilemma_choice_details_localised_choice_label_shield_ally_region_vik_reg_latharnFIRST	Return the Region	true
cdir_events_dilemma_choice_details_localised_choice_label_shield_ally_region_vik_reg_latharnSECOND	Keep the Region	true
cdir_events_dilemma_choice_details_localised_choice_label_shield_ally_region_vik_reg_licetfeldaFIRST	Return the Region	true
cdir_events_dilemma_choice_details_localised_choice_label_shield_ally_region_vik_reg_licetfeldaSECOND	Keep the Region	true
cdir_events_dilemma_choice_details_localised_choice_label_shield_ally_region_vik_reg_ligeraceasterFIRST	Return the Region	true
cdir_events_dilemma_choice_details_localised_choice_label_shield_ally_region_vik_reg_ligeraceasterSECOND	Keep the Region	true
cdir_events_dilemma_choice_details_localised_choice_label_shield_ally_region_vik_reg_lindcylneFIRST	Return the Region	true
cdir_events_dilemma_choice_details_localised_choice_label_shield_ally_region_vik_reg_lindcylneSECOND	Keep the Region	true
cdir_events_dilemma_choice_details_localised_choice_label_shield_ally_region_vik_reg_linnsFIRST	Return the Region	true
cdir_events_dilemma_choice_details_localised_choice_label_shield_ally_region_vik_reg_linnsSECOND	Keep the Region	true
cdir_events_dilemma_choice_details_localised_choice_label_shield_ally_region_vik_reg_lis_morFIRST	Return the Region	true
cdir_events_dilemma_choice_details_localised_choice_label_shield_ally_region_vik_reg_lis_morSECOND	Keep the Region	true
cdir_events_dilemma_choice_details_localised_choice_label_shield_ally_region_vik_reg_liwtuneFIRST	Return the Region	true
cdir_events_dilemma_choice_details_localised_choice_label_shield_ally_region_vik_reg_liwtuneSECOND	Keep the Region	true
cdir_events_dilemma_choice_details_localised_choice_label_shield_ally_region_vik_reg_loch_gabhairFIRST	Return the Region	true
cdir_events_dilemma_choice_details_localised_choice_label_shield_ally_region_vik_reg_loch_gabhairSECOND	Keep the Region	true
cdir_events_dilemma_choice_details_localised_choice_label_shield_ally_region_vik_reg_loch_raichFIRST	Return the Region	true
cdir_events_dilemma_choice_details_localised_choice_label_shield_ally_region_vik_reg_loch_raichSECOND	Keep the Region	true
cdir_events_dilemma_choice_details_localised_choice_label_shield_ally_region_vik_reg_loidisFIRST	Return the Region	true
cdir_events_dilemma_choice_details_localised_choice_label_shield_ally_region_vik_reg_loidisSECOND	Keep the Region	true
cdir_events_dilemma_choice_details_localised_choice_label_shield_ally_region_vik_reg_lonceasterFIRST	Return the Region	true
cdir_events_dilemma_choice_details_localised_choice_label_shield_ally_region_vik_reg_lonceasterSECOND	Keep the Region	true
cdir_events_dilemma_choice_details_localised_choice_label_shield_ally_region_vik_reg_ludeFIRST	Return the Region	true
cdir_events_dilemma_choice_details_localised_choice_label_shield_ally_region_vik_reg_ludeSECOND	Keep the Region	true
cdir_events_dilemma_choice_details_localised_choice_label_shield_ally_region_vik_reg_lundenFIRST	Return the Region	true
cdir_events_dilemma_choice_details_localised_choice_label_shield_ally_region_vik_reg_lundenSECOND	Keep the Region	true
cdir_events_dilemma_choice_details_localised_choice_label_shield_ally_region_vik_reg_maelduneFIRST	Return the Region	true
cdir_events_dilemma_choice_details_localised_choice_label_shield_ally_region_vik_reg_maelduneSECOND	Keep the Region	true
cdir_events_dilemma_choice_details_localised_choice_label_shield_ally_region_vik_reg_mailrosFIRST	Return the Region	true
cdir_events_dilemma_choice_details_localised_choice_label_shield_ally_region_vik_reg_mailrosSECOND	Keep the Region	true
cdir_events_dilemma_choice_details_localised_choice_label_shield_ally_region_vik_reg_mameceasterFIRST	Return the Region	true
cdir_events_dilemma_choice_details_localised_choice_label_shield_ally_region_vik_reg_mameceasterSECOND	Keep the Region	true
cdir_events_dilemma_choice_details_localised_choice_label_shield_ally_region_vik_reg_mathrafalFIRST	Return the Region	true
cdir_events_dilemma_choice_details_localised_choice_label_shield_ally_region_vik_reg_mathrafalSECOND	Keep the Region	true
cdir_events_dilemma_choice_details_localised_choice_label_shield_ally_region_vik_reg_meneviaFIRST	Return the Region	true
cdir_events_dilemma_choice_details_localised_choice_label_shield_ally_region_vik_reg_meneviaSECOND	Keep the Region	true
cdir_events_dilemma_choice_details_localised_choice_label_shield_ally_region_vik_reg_middeherstFIRST	Return the Region	true
cdir_events_dilemma_choice_details_localised_choice_label_shield_ally_region_vik_reg_middeherstSECOND	Keep the Region	true
cdir_events_dilemma_choice_details_localised_choice_label_shield_ally_region_vik_reg_moige_bileFIRST	Return the Region	true
cdir_events_dilemma_choice_details_localised_choice_label_shield_ally_region_vik_reg_moige_bileSECOND	Keep the Region	true
cdir_events_dilemma_choice_details_localised_choice_label_shield_ally_region_vik_reg_na_seciriFIRST	Return the Region	true
cdir_events_dilemma_choice_details_localised_choice_label_shield_ally_region_vik_reg_na_seciriSECOND	Keep the Region	true
cdir_events_dilemma_choice_details_localised_choice_label_shield_ally_region_vik_reg_nasFIRST	Return the Region	true
cdir_events_dilemma_choice_details_localised_choice_label_shield_ally_region_vik_reg_nasSECOND	Keep the Region	true
cdir_events_dilemma_choice_details_localised_choice_label_shield_ally_region_vik_reg_neddFIRST	Return the Region	true
cdir_events_dilemma_choice_details_localised_choice_label_shield_ally_region_vik_reg_neddSECOND	Keep the Region	true
cdir_events_dilemma_choice_details_localised_choice_label_shield_ally_region_vik_reg_northhamtunFIRST	Return the Region	true
cdir_events_dilemma_choice_details_localised_choice_label_shield_ally_region_vik_reg_northhamtunSECOND	Keep the Region	true
cdir_events_dilemma_choice_details_localised_choice_label_shield_ally_region_vik_reg_northwicFIRST	Return the Region	true
cdir_events_dilemma_choice_details_localised_choice_label_shield_ally_region_vik_reg_northwicSECOND	Keep the Region	true
cdir_events_dilemma_choice_details_localised_choice_label_shield_ally_region_vik_reg_oswaldestroeFIRST	Return the Region	true
cdir_events_dilemma_choice_details_localised_choice_label_shield_ally_region_vik_reg_oswaldestroeSECOND	Keep the Region	true
cdir_events_dilemma_choice_details_localised_choice_label_shield_ally_region_vik_reg_otergimeleFIRST	Return the Region	true
cdir_events_dilemma_choice_details_localised_choice_label_shield_ally_region_vik_reg_otergimeleSECOND	Keep the Region	true
cdir_events_dilemma_choice_details_localised_choice_label_shield_ally_region_vik_reg_oxnafordaFIRST	Return the Region	true
cdir_events_dilemma_choice_details_localised_choice_label_shield_ally_region_vik_reg_oxnafordaSECOND	Keep the Region	true
cdir_events_dilemma_choice_details_localised_choice_label_shield_ally_region_vik_reg_pefeneseaFIRST	Return the Region	true
cdir_events_dilemma_choice_details_localised_choice_label_shield_ally_region_vik_reg_pefeneseaSECOND	Keep the Region	true
cdir_events_dilemma_choice_details_localised_choice_label_shield_ally_region_vik_reg_poclintunFIRST	Return the Region	true
cdir_events_dilemma_choice_details_localised_choice_label_shield_ally_region_vik_reg_poclintunSECOND	Keep the Region	true
cdir_events_dilemma_choice_details_localised_choice_label_shield_ally_region_vik_reg_porteceasterFIRST	Return the Region	true
cdir_events_dilemma_choice_details_localised_choice_label_shield_ally_region_vik_reg_porteceasterSECOND	Keep the Region	true
cdir_events_dilemma_choice_details_localised_choice_label_shield_ally_region_vik_reg_rath_cruachanFIRST	Return the Region	true
cdir_events_dilemma_choice_details_localised_choice_label_shield_ally_region_vik_reg_rath_cruachanSECOND	Keep the Region	true
cdir_events_dilemma_choice_details_localised_choice_label_shield_ally_region_vik_reg_rath_luraigFIRST	Return the Region	true
cdir_events_dilemma_choice_details_localised_choice_label_shield_ally_region_vik_reg_rath_luraigSECOND	Keep the Region	true
cdir_events_dilemma_choice_details_localised_choice_label_shield_ally_region_vik_reg_rendleshamFIRST	Return the Region	true
cdir_events_dilemma_choice_details_localised_choice_label_shield_ally_region_vik_reg_rendleshamSECOND	Keep the Region	true
cdir_events_dilemma_choice_details_localised_choice_label_shield_ally_region_vik_reg_rinninFIRST	Return the Region	true
cdir_events_dilemma_choice_details_localised_choice_label_shield_ally_region_vik_reg_rinninSECOND	Keep the Region	true
cdir_events_dilemma_choice_details_localised_choice_label_shield_ally_region_vik_reg_rocheberieFIRST	Return the Region	true
cdir_events_dilemma_choice_details_localised_choice_label_shield_ally_region_vik_reg_rocheberieSECOND	Keep the Region	true
cdir_events_dilemma_choice_details_localised_choice_label_shield_ally_region_vik_reg_rofeceasterFIRST	Return the Region	true
cdir_events_dilemma_choice_details_localised_choice_label_shield_ally_region_vik_reg_rofeceasterSECOND	Keep the Region	true
cdir_events_dilemma_choice_details_localised_choice_label_shield_ally_region_vik_reg_ros_ailithirFIRST	Return the Region	true
cdir_events_dilemma_choice_details_localised_choice_label_shield_ally_region_vik_reg_ros_ailithirSECOND	Keep the Region	true
cdir_events_dilemma_choice_details_localised_choice_label_shield_ally_region_vik_reg_ros_cuissineFIRST	Return the Region	true
cdir_events_dilemma_choice_details_localised_choice_label_shield_ally_region_vik_reg_ros_cuissineSECOND	Keep the Region	true
cdir_events_dilemma_choice_details_localised_choice_label_shield_ally_region_vik_reg_ros_maircindFIRST	Return the Region	true
cdir_events_dilemma_choice_details_localised_choice_label_shield_ally_region_vik_reg_ros_maircindSECOND	Keep the Region	true
cdir_events_dilemma_choice_details_localised_choice_label_shield_ally_region_vik_reg_rosFIRST	Return the Region	true
cdir_events_dilemma_choice_details_localised_choice_label_shield_ally_region_vik_reg_rosSECOND	Keep the Region	true
cdir_events_dilemma_choice_details_localised_choice_label_shield_ally_region_vik_reg_rucestrFIRST	Return the Region	true
cdir_events_dilemma_choice_details_localised_choice_label_shield_ally_region_vik_reg_rucestrSECOND	Keep the Region	true
cdir_events_dilemma_choice_details_localised_choice_label_shield_ally_region_vik_reg_rudglannFIRST	Return the Region	true
cdir_events_dilemma_choice_details_localised_choice_label_shield_ally_region_vik_reg_rudglannSECOND	Keep the Region	true
cdir_events_dilemma_choice_details_localised_choice_label_shield_ally_region_vik_reg_saigherFIRST	Return the Region	true
cdir_events_dilemma_choice_details_localised_choice_label_shield_ally_region_vik_reg_saigherSECOND	Keep the Region	true
cdir_events_dilemma_choice_details_localised_choice_label_shield_ally_region_vik_reg_sancte_albanesFIRST	Return the Region	true
cdir_events_dilemma_choice_details_localised_choice_label_shield_ally_region_vik_reg_sancte_albanesSECOND	Keep the Region	true
cdir_events_dilemma_choice_details_localised_choice_label_shield_ally_region_vik_reg_sancte_eadmundesFIRST	Return the Region	true
cdir_events_dilemma_choice_details_localised_choice_label_shield_ally_region_vik_reg_sancte_eadmundesSECOND	Keep the Region	true
cdir_events_dilemma_choice_details_localised_choice_label_shield_ally_region_vik_reg_sancte_germanesFIRST	Return the Region	true
cdir_events_dilemma_choice_details_localised_choice_label_shield_ally_region_vik_reg_sancte_germanesSECOND	Keep the Region	true
cdir_events_dilemma_choice_details_localised_choice_label_shield_ally_region_vik_reg_sancte_yeFIRST	Return the Region	true
cdir_events_dilemma_choice_details_localised_choice_label_shield_ally_region_vik_reg_sancte_yeSECOND	Keep the Region	true
cdir_events_dilemma_choice_details_localised_choice_label_shield_ally_region_vik_reg_sceaftesburgFIRST	Return the Region	true
cdir_events_dilemma_choice_details_localised_choice_label_shield_ally_region_vik_reg_sceaftesburgSECOND	Keep the Region	true
cdir_events_dilemma_choice_details_localised_choice_label_shield_ally_region_vik_reg_scireburnanFIRST	Return the Region	true
cdir_events_dilemma_choice_details_localised_choice_label_shield_ally_region_vik_reg_scireburnanSECOND	Keep the Region	true
cdir_events_dilemma_choice_details_localised_choice_label_shield_ally_region_vik_reg_scoanFIRST	Return the Region	true
cdir_events_dilemma_choice_details_localised_choice_label_shield_ally_region_vik_reg_scoanSECOND	Keep the Region	true
cdir_events_dilemma_choice_details_localised_choice_label_shield_ally_region_vik_reg_sconninFIRST	Return the Region	true
cdir_events_dilemma_choice_details_localised_choice_label_shield_ally_region_vik_reg_sconninSECOND	Keep the Region	true
cdir_events_dilemma_choice_details_localised_choice_label_shield_ally_region_vik_reg_scrobbesburgFIRST	Return the Region	true
cdir_events_dilemma_choice_details_localised_choice_label_shield_ally_region_vik_reg_scrobbesburgSECOND	Keep the Region	true
cdir_events_dilemma_choice_details_localised_choice_label_shield_ally_region_vik_reg_seolesiggeFIRST	Return the Region	true
cdir_events_dilemma_choice_details_localised_choice_label_shield_ally_region_vik_reg_seolesiggeSECOND	Keep the Region	true
cdir_events_dilemma_choice_details_localised_choice_label_shield_ally_region_vik_reg_snotingahamFIRST	Return the Region	true
cdir_events_dilemma_choice_details_localised_choice_label_shield_ally_region_vik_reg_snotingahamSECOND	Keep the Region	true
cdir_events_dilemma_choice_details_localised_choice_label_shield_ally_region_vik_reg_sreth_belinFIRST	Return the Region	true
cdir_events_dilemma_choice_details_localised_choice_label_shield_ally_region_vik_reg_sreth_belinSECOND	Keep the Region	true
cdir_events_dilemma_choice_details_localised_choice_label_shield_ally_region_vik_reg_staeffordFIRST	Return the Region	true
cdir_events_dilemma_choice_details_localised_choice_label_shield_ally_region_vik_reg_staeffordSECOND	Keep the Region	true
cdir_events_dilemma_choice_details_localised_choice_label_shield_ally_region_vik_reg_staeningumFIRST	Return the Region	true
cdir_events_dilemma_choice_details_localised_choice_label_shield_ally_region_vik_reg_staeningumSECOND	Keep the Region	true
cdir_events_dilemma_choice_details_localised_choice_label_shield_ally_region_vik_reg_steanfordFIRST	Return the Region	true
cdir_events_dilemma_choice_details_localised_choice_label_shield_ally_region_vik_reg_steanfordSECOND	Keep the Region	true
cdir_events_dilemma_choice_details_localised_choice_label_shield_ally_region_vik_reg_stocFIRST	Return the Region	true
cdir_events_dilemma_choice_details_localised_choice_label_shield_ally_region_vik_reg_stocSECOND	Keep the Region	true
cdir_events_dilemma_choice_details_localised_choice_label_shield_ally_region_vik_reg_stornochwayFIRST	Return the Region	true
cdir_events_dilemma_choice_details_localised_choice_label_shield_ally_region_vik_reg_stornochwaySECOND	Keep the Region	true
cdir_events_dilemma_choice_details_localised_choice_label_shield_ally_region_vik_reg_stutfallFIRST	Return the Region	true
cdir_events_dilemma_choice_details_localised_choice_label_shield_ally_region_vik_reg_stutfallSECOND	Keep the Region	true
cdir_events_dilemma_choice_details_localised_choice_label_shield_ally_region_vik_reg_suthhamtunFIRST	Return the Region	true
cdir_events_dilemma_choice_details_localised_choice_label_shield_ally_region_vik_reg_suthhamtunSECOND	Keep the Region	true
cdir_events_dilemma_choice_details_localised_choice_label_shield_ally_region_vik_reg_tamworthigeFIRST	Return the Region	true
cdir_events_dilemma_choice_details_localised_choice_label_shield_ally_region_vik_reg_tamworthigeSECOND	Keep the Region	true
cdir_events_dilemma_choice_details_localised_choice_label_shield_ally_region_vik_reg_tanetFIRST	Return the Region	true
cdir_events_dilemma_choice_details_localised_choice_label_shield_ally_region_vik_reg_tanetSECOND	Keep the Region	true
cdir_events_dilemma_choice_details_localised_choice_label_shield_ally_region_vik_reg_terra_incognitaFIRST	Return the Region	true
cdir_events_dilemma_choice_details_localised_choice_label_shield_ally_region_vik_reg_terra_incognitaSECOND	Keep the Region	true
cdir_events_dilemma_choice_details_localised_choice_label_shield_ally_region_vik_reg_theodfordFIRST	Return the Region	true
cdir_events_dilemma_choice_details_localised_choice_label_shield_ally_region_vik_reg_theodfordSECOND	Keep the Region	true
cdir_events_dilemma_choice_details_localised_choice_label_shield_ally_region_vik_reg_thursaFIRST	Return the Region	true
cdir_events_dilemma_choice_details_localised_choice_label_shield_ally_region_vik_reg_thursaSECOND	Keep the Region	true
cdir_events_dilemma_choice_details_localised_choice_label_shield_ally_region_vik_reg_tilaburgFIRST	Return the Region	true
cdir_events_dilemma_choice_details_localised_choice_label_shield_ally_region_vik_reg_tilaburgSECOND	Keep the Region	true
cdir_events_dilemma_choice_details_localised_choice_label_shield_ally_region_vik_reg_tintagolFIRST	Return the Region	true
cdir_events_dilemma_choice_details_localised_choice_label_shield_ally_region_vik_reg_tintagolSECOND	Keep the Region	true
cdir_events_dilemma_choice_details_localised_choice_label_shield_ally_region_vik_reg_tor_in_duineFIRST	Return the Region	true
cdir_events_dilemma_choice_details_localised_choice_label_shield_ally_region_vik_reg_tor_in_duineSECOND	Keep the Region	true
cdir_events_dilemma_choice_details_localised_choice_label_shield_ally_region_vik_reg_torfnessFIRST	Return the Region	true
cdir_events_dilemma_choice_details_localised_choice_label_shield_ally_region_vik_reg_torfnessSECOND	Keep the Region	true
cdir_events_dilemma_choice_details_localised_choice_label_shield_ally_region_vik_reg_totanesFIRST	Return the Region	true
cdir_events_dilemma_choice_details_localised_choice_label_shield_ally_region_vik_reg_totanesSECOND	Keep the Region	true
cdir_events_dilemma_choice_details_localised_choice_label_shield_ally_region_vik_reg_tuaimFIRST	Return the Region	true
cdir_events_dilemma_choice_details_localised_choice_label_shield_ally_region_vik_reg_tuaimSECOND	Keep the Region	true
cdir_events_dilemma_choice_details_localised_choice_label_shield_ally_region_vik_reg_tuam_greineFIRST	Return the Region	true
cdir_events_dilemma_choice_details_localised_choice_label_shield_ally_region_vik_reg_tuam_greineSECOND	Keep the Region	true
cdir_events_dilemma_choice_details_localised_choice_label_shield_ally_region_vik_reg_tureceseigFIRST	Return the Region	true
cdir_events_dilemma_choice_details_localised_choice_label_shield_ally_region_vik_reg_tureceseigSECOND	Keep the Region	true
cdir_events_dilemma_choice_details_localised_choice_label_shield_ally_region_vik_reg_vedrafjordrFIRST	Return the Region	true
cdir_events_dilemma_choice_details_localised_choice_label_shield_ally_region_vik_reg_vedrafjordrSECOND	Keep the Region	true
cdir_events_dilemma_choice_details_localised_choice_label_shield_ally_region_vik_reg_veisafjordrFIRST	Return the Region	true
cdir_events_dilemma_choice_details_localised_choice_label_shield_ally_region_vik_reg_veisafjordrSECOND	Keep the Region	true
cdir_events_dilemma_choice_details_localised_choice_label_shield_ally_region_vik_reg_waecetFIRST	Return the Region	true
cdir_events_dilemma_choice_details_localised_choice_label_shield_ally_region_vik_reg_waecetSECOND	Keep the Region	true
cdir_events_dilemma_choice_details_localised_choice_label_shield_ally_region_vik_reg_waerincwicumFIRST	Return the Region	true
cdir_events_dilemma_choice_details_localised_choice_label_shield_ally_region_vik_reg_waerincwicumSECOND	Keep the Region	true
cdir_events_dilemma_choice_details_localised_choice_label_shield_ally_region_vik_reg_werhamFIRST	Return the Region	true
cdir_events_dilemma_choice_details_localised_choice_label_shield_ally_region_vik_reg_werhamSECOND	Keep the Region	true
cdir_events_dilemma_choice_details_localised_choice_label_shield_ally_region_vik_reg_wigingamereFIRST	Return the Region	true
cdir_events_dilemma_choice_details_localised_choice_label_shield_ally_region_vik_reg_wigingamereSECOND	Keep the Region	true
cdir_events_dilemma_choice_details_localised_choice_label_shield_ally_region_vik_reg_wigracestreFIRST	Return the Region	true
cdir_events_dilemma_choice_details_localised_choice_label_shield_ally_region_vik_reg_wigracestreSECOND	Keep the Region	true
cdir_events_dilemma_choice_details_localised_choice_label_shield_ally_region_vik_reg_wihtFIRST	Return the Region	true
cdir_events_dilemma_choice_details_localised_choice_label_shield_ally_region_vik_reg_wihtSECOND	Keep the Region	true
cdir_events_dilemma_choice_details_localised_choice_label_shield_ally_region_vik_reg_wiltunFIRST	Return the Region	true
cdir_events_dilemma_choice_details_localised_choice_label_shield_ally_region_vik_reg_wiltunSECOND	Keep the Region	true
cdir_events_dilemma_choice_details_localised_choice_label_shield_ally_region_vik_reg_wintanceasterFIRST	Return the Region	true
cdir_events_dilemma_choice_details_localised_choice_label_shield_ally_region_vik_reg_wintanceasterSECOND	Keep the Region	true
cdir_events_dilemma_choice_details_localised_choice_label_shield_ally_region_vik_reg_wyrcesuuyrtheFIRST	Return the Region	true
cdir_events_dilemma_choice_details_localised_choice_label_shield_ally_region_vik_reg_wyrcesuuyrtheSECOND	Keep the Region	true
cdir_events_dilemma_choice_details_localised_choice_title_shield_ally_region_vik_reg_abberdeonFIRST	We must honour the rights of our ally and return this land to their king.	true
cdir_events_dilemma_choice_details_localised_choice_title_shield_ally_region_vik_reg_abberdeonSECOND	Our ally will surely be angered by our theft of their land.	true
cdir_events_dilemma_choice_details_localised_choice_title_shield_ally_region_vik_reg_aberffroFIRST	We must honour the rights of our ally and return this land to their king.	true
cdir_events_dilemma_choice_details_localised_choice_title_shield_ally_region_vik_reg_aberffroSECOND	Our ally will surely be angered by our theft of their land.	true
cdir_events_dilemma_choice_details_localised_choice_title_shield_ally_region_vik_reg_aberteifiFIRST	We must honour the rights of our ally and return this land to their king.	true
cdir_events_dilemma_choice_details_localised_choice_title_shield_ally_region_vik_reg_aberteifiSECOND	Our ally will surely be angered by our theft of their land.	true
cdir_events_dilemma_choice_details_localised_choice_title_shield_ally_region_vik_reg_achadh_boFIRST	We must honour the rights of our ally and return this land to their king.	true
cdir_events_dilemma_choice_details_localised_choice_title_shield_ally_region_vik_reg_achadh_boSECOND	Our ally will surely be angered by our theft of their land.	true
cdir_events_dilemma_choice_details_localised_choice_title_shield_ally_region_vik_reg_aebburcurnigFIRST	We must honour the rights of our ally and return this land to their king.	true
cdir_events_dilemma_choice_details_localised_choice_title_shield_ally_region_vik_reg_aebburcurnigSECOND	Our ally will surely be angered by our theft of their land.	true
cdir_events_dilemma_choice_details_localised_choice_title_shield_ally_region_vik_reg_aelmhamFIRST	We must honour the rights of our ally and return this land to their king.	true
cdir_events_dilemma_choice_details_localised_choice_title_shield_ally_region_vik_reg_aelmhamSECOND	Our ally will surely be angered by our theft of their land.	true
cdir_events_dilemma_choice_details_localised_choice_title_shield_ally_region_vik_reg_aethelingaegFIRST	We must honour the rights of our ally and return this land to their king.	true
cdir_events_dilemma_choice_details_localised_choice_title_shield_ally_region_vik_reg_aethelingaegSECOND	Our ally will surely be angered by our theft of their land.	true
cdir_events_dilemma_choice_details_localised_choice_title_shield_ally_region_vik_reg_airchardanFIRST	We must honour the rights of our ally and return this land to their king.	true
cdir_events_dilemma_choice_details_localised_choice_title_shield_ally_region_vik_reg_airchardanSECOND	Our ally will surely be angered by our theft of their land.	true
cdir_events_dilemma_choice_details_localised_choice_title_shield_ally_region_vik_reg_alclytFIRST	We must honour the rights of our ally and return this land to their king.	true
cdir_events_dilemma_choice_details_localised_choice_title_shield_ally_region_vik_reg_alclytSECOND	Our ally will surely be angered by our theft of their land.	true
cdir_events_dilemma_choice_details_localised_choice_title_shield_ally_region_vik_reg_alt_clutFIRST	We must honour the rights of our ally and return this land to their king.	true
cdir_events_dilemma_choice_details_localised_choice_title_shield_ally_region_vik_reg_alt_clutSECOND	Our ally will surely be angered by our theft of their land.	true
cdir_events_dilemma_choice_details_localised_choice_title_shield_ally_region_vik_reg_an_tinbhear_morFIRST	We must honour the rights of our ally and return this land to their king.	true
cdir_events_dilemma_choice_details_localised_choice_title_shield_ally_region_vik_reg_an_tinbhear_morSECOND	Our ally will surely be angered by our theft of their land.	true
cdir_events_dilemma_choice_details_localised_choice_title_shield_ally_region_vik_reg_aporcrosanFIRST	We must honour the rights of our ally and return this land to their king.	true
cdir_events_dilemma_choice_details_localised_choice_title_shield_ally_region_vik_reg_aporcrosanSECOND	Our ally will surely be angered by our theft of their land.	true
cdir_events_dilemma_choice_details_localised_choice_title_shield_ally_region_vik_reg_ard_fertFIRST	We must honour the rights of our ally and return this land to their king.	true
cdir_events_dilemma_choice_details_localised_choice_title_shield_ally_region_vik_reg_ard_fertSECOND	Our ally will surely be angered by our theft of their land.	true
cdir_events_dilemma_choice_details_localised_choice_title_shield_ally_region_vik_reg_ard_machaFIRST	We must honour the rights of our ally and return this land to their king.	true
cdir_events_dilemma_choice_details_localised_choice_title_shield_ally_region_vik_reg_ard_machaSECOND	Our ally will surely be angered by our theft of their land.	true
cdir_events_dilemma_choice_details_localised_choice_title_shield_ally_region_vik_reg_ard_morFIRST	We must honour the rights of our ally and return this land to their king.	true
cdir_events_dilemma_choice_details_localised_choice_title_shield_ally_region_vik_reg_ard_morSECOND	Our ally will surely be angered by our theft of their land.	true
cdir_events_dilemma_choice_details_localised_choice_title_shield_ally_region_vik_reg_ard_srathaFIRST	We must honour the rights of our ally and return this land to their king.	true
cdir_events_dilemma_choice_details_localised_choice_title_shield_ally_region_vik_reg_ard_srathaSECOND	Our ally will surely be angered by our theft of their land.	true
cdir_events_dilemma_choice_details_localised_choice_title_shield_ally_region_vik_reg_ardachFIRST	We must honour the rights of our ally and return this land to their king.	true
cdir_events_dilemma_choice_details_localised_choice_title_shield_ally_region_vik_reg_ardachSECOND	Our ally will surely be angered by our theft of their land.	true
cdir_events_dilemma_choice_details_localised_choice_title_shield_ally_region_vik_reg_axanbrycgFIRST	We must honour the rights of our ally and return this land to their king.	true
cdir_events_dilemma_choice_details_localised_choice_title_shield_ally_region_vik_reg_axanbrycgSECOND	Our ally will surely be angered by our theft of their land.	true
cdir_events_dilemma_choice_details_localised_choice_title_shield_ally_region_vik_reg_ballaFIRST	We must honour the rights of our ally and return this land to their king.	true
cdir_events_dilemma_choice_details_localised_choice_title_shield_ally_region_vik_reg_ballaSECOND	Our ally will surely be angered by our theft of their land.	true
cdir_events_dilemma_choice_details_localised_choice_title_shield_ally_region_vik_reg_basengasFIRST	We must honour the rights of our ally and return this land to their king.	true
cdir_events_dilemma_choice_details_localised_choice_title_shield_ally_region_vik_reg_basengasSECOND	Our ally will surely be angered by our theft of their land.	true
cdir_events_dilemma_choice_details_localised_choice_title_shield_ally_region_vik_reg_bathanceasterFIRST	We must honour the rights of our ally and return this land to their king.	true
cdir_events_dilemma_choice_details_localised_choice_title_shield_ally_region_vik_reg_bathanceasterSECOND	Our ally will surely be angered by our theft of their land.	true
cdir_events_dilemma_choice_details_localised_choice_title_shield_ally_region_vik_reg_bebbanburgFIRST	We must honour the rights of our ally and return this land to their king.	true
cdir_events_dilemma_choice_details_localised_choice_title_shield_ally_region_vik_reg_bebbanburgSECOND	Our ally will surely be angered by our theft of their land.	true
cdir_events_dilemma_choice_details_localised_choice_title_shield_ally_region_vik_reg_bedanfordFIRST	We must honour the rights of our ally and return this land to their king.	true
cdir_events_dilemma_choice_details_localised_choice_title_shield_ally_region_vik_reg_bedanfordSECOND	Our ally will surely be angered by our theft of their land.	true
cdir_events_dilemma_choice_details_localised_choice_title_shield_ally_region_vik_reg_beoferlicFIRST	We must honour the rights of our ally and return this land to their king.	true
cdir_events_dilemma_choice_details_localised_choice_title_shield_ally_region_vik_reg_beoferlicSECOND	Our ally will surely be angered by our theft of their land.	true
cdir_events_dilemma_choice_details_localised_choice_title_shield_ally_region_vik_reg_blasconaFIRST	We must honour the rights of our ally and return this land to their king.	true
cdir_events_dilemma_choice_details_localised_choice_title_shield_ally_region_vik_reg_blasconaSECOND	Our ally will surely be angered by our theft of their land.	true
cdir_events_dilemma_choice_details_localised_choice_title_shield_ally_region_vik_reg_bodmineFIRST	We must honour the rights of our ally and return this land to their king.	true
cdir_events_dilemma_choice_details_localised_choice_title_shield_ally_region_vik_reg_bodmineSECOND	Our ally will surely be angered by our theft of their land.	true
cdir_events_dilemma_choice_details_localised_choice_title_shield_ally_region_vik_reg_bornaisFIRST	We must honour the rights of our ally and return this land to their king.	true
cdir_events_dilemma_choice_details_localised_choice_title_shield_ally_region_vik_reg_bornaisSECOND	Our ally will surely be angered by our theft of their land.	true
cdir_events_dilemma_choice_details_localised_choice_title_shield_ally_region_vik_reg_brechinFIRST	We must honour the rights of our ally and return this land to their king.	true
cdir_events_dilemma_choice_details_localised_choice_title_shield_ally_region_vik_reg_brechinSECOND	Our ally will surely be angered by our theft of their land.	true
cdir_events_dilemma_choice_details_localised_choice_title_shield_ally_region_vik_reg_brideportFIRST	We must honour the rights of our ally and return this land to their king.	true
cdir_events_dilemma_choice_details_localised_choice_title_shield_ally_region_vik_reg_brideportSECOND	Our ally will surely be angered by our theft of their land.	true
cdir_events_dilemma_choice_details_localised_choice_title_shield_ally_region_vik_reg_brugFIRST	We must honour the rights of our ally and return this land to their king.	true
cdir_events_dilemma_choice_details_localised_choice_title_shield_ally_region_vik_reg_brugSECOND	Our ally will surely be angered by our theft of their land.	true
cdir_events_dilemma_choice_details_localised_choice_title_shield_ally_region_vik_reg_buccingahammFIRST	We must honour the rights of our ally and return this land to their king.	true
cdir_events_dilemma_choice_details_localised_choice_title_shield_ally_region_vik_reg_buccingahammSECOND	Our ally will surely be angered by our theft of their land.	true
cdir_events_dilemma_choice_details_localised_choice_title_shield_ally_region_vik_reg_cair_gwentFIRST	We must honour the rights of our ally and return this land to their king.	true
cdir_events_dilemma_choice_details_localised_choice_title_shield_ally_region_vik_reg_cair_gwentSECOND	Our ally will surely be angered by our theft of their land.	true
cdir_events_dilemma_choice_details_localised_choice_title_shield_ally_region_vik_reg_cair_mirddinFIRST	We must honour the rights of our ally and return this land to their king.	true
cdir_events_dilemma_choice_details_localised_choice_title_shield_ally_region_vik_reg_cair_mirddinSECOND	Our ally will surely be angered by our theft of their land.	true
cdir_events_dilemma_choice_details_localised_choice_title_shield_ally_region_vik_reg_cair_segeintFIRST	We must honour the rights of our ally and return this land to their king.	true
cdir_events_dilemma_choice_details_localised_choice_title_shield_ally_region_vik_reg_cair_segeintSECOND	Our ally will surely be angered by our theft of their land.	true
cdir_events_dilemma_choice_details_localised_choice_title_shield_ally_region_vik_reg_cairlinnFIRST	We must honour the rights of our ally and return this land to their king.	true
cdir_events_dilemma_choice_details_localised_choice_title_shield_ally_region_vik_reg_cairlinnSECOND	Our ally will surely be angered by our theft of their land.	true
cdir_events_dilemma_choice_details_localised_choice_title_shield_ally_region_vik_reg_caisilFIRST	We must honour the rights of our ally and return this land to their king.	true
cdir_events_dilemma_choice_details_localised_choice_title_shield_ally_region_vik_reg_caisilSECOND	Our ally will surely be angered by our theft of their land.	true
cdir_events_dilemma_choice_details_localised_choice_title_shield_ally_region_vik_reg_cantwaraburgFIRST	We must honour the rights of our ally and return this land to their king.	true
cdir_events_dilemma_choice_details_localised_choice_title_shield_ally_region_vik_reg_cantwaraburgSECOND	Our ally will surely be angered by our theft of their land.	true
cdir_events_dilemma_choice_details_localised_choice_title_shield_ally_region_vik_reg_carleolFIRST	We must honour the rights of our ally and return this land to their king.	true
cdir_events_dilemma_choice_details_localised_choice_title_shield_ally_region_vik_reg_carleolSECOND	Our ally will surely be angered by our theft of their land.	true
cdir_events_dilemma_choice_details_localised_choice_title_shield_ally_region_vik_reg_casteltounFIRST	We must honour the rights of our ally and return this land to their king.	true
cdir_events_dilemma_choice_details_localised_choice_title_shield_ally_region_vik_reg_casteltounSECOND	Our ally will surely be angered by our theft of their land.	true
cdir_events_dilemma_choice_details_localised_choice_title_shield_ally_region_vik_reg_cathair_commainFIRST	We must honour the rights of our ally and return this land to their king.	true
cdir_events_dilemma_choice_details_localised_choice_title_shield_ally_region_vik_reg_cathair_commainSECOND	Our ally will surely be angered by our theft of their land.	true
cdir_events_dilemma_choice_details_localised_choice_title_shield_ally_region_vik_reg_cathair_domnaillFIRST	We must honour the rights of our ally and return this land to their king.	true
cdir_events_dilemma_choice_details_localised_choice_title_shield_ally_region_vik_reg_cathair_domnaillSECOND	Our ally will surely be angered by our theft of their land.	true
cdir_events_dilemma_choice_details_localised_choice_title_shield_ally_region_vik_reg_ceasterFIRST	We must honour the rights of our ally and return this land to their king.	true
cdir_events_dilemma_choice_details_localised_choice_title_shield_ally_region_vik_reg_ceasterSECOND	Our ally will surely be angered by our theft of their land.	true
cdir_events_dilemma_choice_details_localised_choice_title_shield_ally_region_vik_reg_cell_alaidFIRST	We must honour the rights of our ally and return this land to their king.	true
cdir_events_dilemma_choice_details_localised_choice_title_shield_ally_region_vik_reg_cell_alaidSECOND	Our ally will surely be angered by our theft of their land.	true
cdir_events_dilemma_choice_details_localised_choice_title_shield_ally_region_vik_reg_cell_cainningFIRST	We must honour the rights of our ally and return this land to their king.	true
cdir_events_dilemma_choice_details_localised_choice_title_shield_ally_region_vik_reg_cell_cainningSECOND	Our ally will surely be angered by our theft of their land.	true
cdir_events_dilemma_choice_details_localised_choice_title_shield_ally_region_vik_reg_cell_daltainFIRST	We must honour the rights of our ally and return this land to their king.	true
cdir_events_dilemma_choice_details_localised_choice_title_shield_ally_region_vik_reg_cell_daltainSECOND	Our ally will surely be angered by our theft of their land.	true
cdir_events_dilemma_choice_details_localised_choice_title_shield_ally_region_vik_reg_cell_maic_aedaFIRST	We must honour the rights of our ally and return this land to their king.	true
cdir_events_dilemma_choice_details_localised_choice_title_shield_ally_region_vik_reg_cell_maic_aedaSECOND	Our ally will surely be angered by our theft of their land.	true
cdir_events_dilemma_choice_details_localised_choice_title_shield_ally_region_vik_reg_cell_morFIRST	We must honour the rights of our ally and return this land to their king.	true
cdir_events_dilemma_choice_details_localised_choice_title_shield_ally_region_vik_reg_cell_morSECOND	Our ally will surely be angered by our theft of their land.	true
cdir_events_dilemma_choice_details_localised_choice_title_shield_ally_region_vik_reg_celmeresfortFIRST	We must honour the rights of our ally and return this land to their king.	true
cdir_events_dilemma_choice_details_localised_choice_title_shield_ally_region_vik_reg_celmeresfortSECOND	Our ally will surely be angered by our theft of their land.	true
cdir_events_dilemma_choice_details_localised_choice_title_shield_ally_region_vik_reg_cenannasFIRST	We must honour the rights of our ally and return this land to their king.	true
cdir_events_dilemma_choice_details_localised_choice_title_shield_ally_region_vik_reg_cenannasSECOND	Our ally will surely be angered by our theft of their land.	true
cdir_events_dilemma_choice_details_localised_choice_title_shield_ally_region_vik_reg_cenn_rigmonidFIRST	We must honour the rights of our ally and return this land to their king.	true
cdir_events_dilemma_choice_details_localised_choice_title_shield_ally_region_vik_reg_cenn_rigmonidSECOND	Our ally will surely be angered by our theft of their land.	true
cdir_events_dilemma_choice_details_localised_choice_title_shield_ally_region_vik_reg_cetrethaFIRST	We must honour the rights of our ally and return this land to their king.	true
cdir_events_dilemma_choice_details_localised_choice_title_shield_ally_region_vik_reg_cetrethaSECOND	Our ally will surely be angered by our theft of their land.	true
cdir_events_dilemma_choice_details_localised_choice_title_shield_ally_region_vik_reg_cherchebiFIRST	We must honour the rights of our ally and return this land to their king.	true
cdir_events_dilemma_choice_details_localised_choice_title_shield_ally_region_vik_reg_cherchebiSECOND	Our ally will surely be angered by our theft of their land.	true
cdir_events_dilemma_choice_details_localised_choice_title_shield_ally_region_vik_reg_cippanhammFIRST	We must honour the rights of our ally and return this land to their king.	true
cdir_events_dilemma_choice_details_localised_choice_title_shield_ally_region_vik_reg_cippanhammSECOND	Our ally will surely be angered by our theft of their land.	true
cdir_events_dilemma_choice_details_localised_choice_title_shield_ally_region_vik_reg_cirenceasterFIRST	We must honour the rights of our ally and return this land to their king.	true
cdir_events_dilemma_choice_details_localised_choice_title_shield_ally_region_vik_reg_cirenceasterSECOND	Our ally will surely be angered by our theft of their land.	true
cdir_events_dilemma_choice_details_localised_choice_title_shield_ally_region_vik_reg_cissanbyrigFIRST	We must honour the rights of our ally and return this land to their king.	true
cdir_events_dilemma_choice_details_localised_choice_title_shield_ally_region_vik_reg_cissanbyrigSECOND	Our ally will surely be angered by our theft of their land.	true
cdir_events_dilemma_choice_details_localised_choice_title_shield_ally_region_vik_reg_clocherFIRST	We must honour the rights of our ally and return this land to their king.	true
cdir_events_dilemma_choice_details_localised_choice_title_shield_ally_region_vik_reg_clocherSECOND	Our ally will surely be angered by our theft of their land.	true
cdir_events_dilemma_choice_details_localised_choice_title_shield_ally_region_vik_reg_cluain_eoaisFIRST	We must honour the rights of our ally and return this land to their king.	true
cdir_events_dilemma_choice_details_localised_choice_title_shield_ally_region_vik_reg_cluain_eoaisSECOND	Our ally will surely be angered by our theft of their land.	true
cdir_events_dilemma_choice_details_localised_choice_title_shield_ally_region_vik_reg_cluain_irairdFIRST	We must honour the rights of our ally and return this land to their king.	true
cdir_events_dilemma_choice_details_localised_choice_title_shield_ally_region_vik_reg_cluain_irairdSECOND	Our ally will surely be angered by our theft of their land.	true
cdir_events_dilemma_choice_details_localised_choice_title_shield_ally_region_vik_reg_cluain_mac_noisFIRST	We must honour the rights of our ally and return this land to their king.	true
cdir_events_dilemma_choice_details_localised_choice_title_shield_ally_region_vik_reg_cluain_mac_noisSECOND	Our ally will surely be angered by our theft of their land.	true
cdir_events_dilemma_choice_details_localised_choice_title_shield_ally_region_vik_reg_cluain_morFIRST	We must honour the rights of our ally and return this land to their king.	true
cdir_events_dilemma_choice_details_localised_choice_title_shield_ally_region_vik_reg_cluain_morSECOND	Our ally will surely be angered by our theft of their land.	true
cdir_events_dilemma_choice_details_localised_choice_title_shield_ally_region_vik_reg_cluainFIRST	We must honour the rights of our ally and return this land to their king.	true
cdir_events_dilemma_choice_details_localised_choice_title_shield_ally_region_vik_reg_cluainSECOND	Our ally will surely be angered by our theft of their land.	true
cdir_events_dilemma_choice_details_localised_choice_title_shield_ally_region_vik_reg_cnodbaFIRST	We must honour the rights of our ally and return this land to their king.	true
cdir_events_dilemma_choice_details_localised_choice_title_shield_ally_region_vik_reg_cnodbaSECOND	Our ally will surely be angered by our theft of their land.	true
cdir_events_dilemma_choice_details_localised_choice_title_shield_ally_region_vik_reg_coinnireFIRST	We must honour the rights of our ally and return this land to their king.	true
cdir_events_dilemma_choice_details_localised_choice_title_shield_ally_region_vik_reg_coinnireSECOND	Our ally will surely be angered by our theft of their land.	true
cdir_events_dilemma_choice_details_localised_choice_title_shield_ally_region_vik_reg_coldingahamFIRST	We must honour the rights of our ally and return this land to their king.	true
cdir_events_dilemma_choice_details_localised_choice_title_shield_ally_region_vik_reg_coldingahamSECOND	Our ally will surely be angered by our theft of their land.	true
cdir_events_dilemma_choice_details_localised_choice_title_shield_ally_region_vik_reg_colneceasterFIRST	We must honour the rights of our ally and return this land to their king.	true
cdir_events_dilemma_choice_details_localised_choice_title_shield_ally_region_vik_reg_colneceasterSECOND	Our ally will surely be angered by our theft of their land.	true
cdir_events_dilemma_choice_details_localised_choice_title_shield_ally_region_vik_reg_corcachFIRST	We must honour the rights of our ally and return this land to their king.	true
cdir_events_dilemma_choice_details_localised_choice_title_shield_ally_region_vik_reg_corcachSECOND	Our ally will surely be angered by our theft of their land.	true
cdir_events_dilemma_choice_details_localised_choice_title_shield_ally_region_vik_reg_cridiatuneFIRST	We must honour the rights of our ally and return this land to their king.	true
cdir_events_dilemma_choice_details_localised_choice_title_shield_ally_region_vik_reg_cridiatuneSECOND	Our ally will surely be angered by our theft of their land.	true
cdir_events_dilemma_choice_details_localised_choice_title_shield_ally_region_vik_reg_dacorFIRST	We must honour the rights of our ally and return this land to their king.	true
cdir_events_dilemma_choice_details_localised_choice_title_shield_ally_region_vik_reg_dacorSECOND	Our ally will surely be angered by our theft of their land.	true
cdir_events_dilemma_choice_details_localised_choice_title_shield_ally_region_vik_reg_dearFIRST	We must honour the rights of our ally and return this land to their king.	true
cdir_events_dilemma_choice_details_localised_choice_title_shield_ally_region_vik_reg_dearSECOND	Our ally will surely be angered by our theft of their land.	true
cdir_events_dilemma_choice_details_localised_choice_title_shield_ally_region_vik_reg_deorabyFIRST	We must honour the rights of our ally and return this land to their king.	true
cdir_events_dilemma_choice_details_localised_choice_title_shield_ally_region_vik_reg_deorabySECOND	Our ally will surely be angered by our theft of their land.	true
cdir_events_dilemma_choice_details_localised_choice_title_shield_ally_region_vik_reg_din_prysFIRST	We must honour the rights of our ally and return this land to their king.	true
cdir_events_dilemma_choice_details_localised_choice_title_shield_ally_region_vik_reg_din_prysSECOND	Our ally will surely be angered by our theft of their land.	true
cdir_events_dilemma_choice_details_localised_choice_title_shield_ally_region_vik_reg_dinas_powisFIRST	We must honour the rights of our ally and return this land to their king.	true
cdir_events_dilemma_choice_details_localised_choice_title_shield_ally_region_vik_reg_dinas_powisSECOND	Our ally will surely be angered by our theft of their land.	true
cdir_events_dilemma_choice_details_localised_choice_title_shield_ally_region_vik_reg_dinefwrFIRST	We must honour the rights of our ally and return this land to their king.	true
cdir_events_dilemma_choice_details_localised_choice_title_shield_ally_region_vik_reg_dinefwrSECOND	Our ally will surely be angered by our theft of their land.	true
cdir_events_dilemma_choice_details_localised_choice_title_shield_ally_region_vik_reg_dofereFIRST	We must honour the rights of our ally and return this land to their king.	true
cdir_events_dilemma_choice_details_localised_choice_title_shield_ally_region_vik_reg_dofereSECOND	Our ally will surely be angered by our theft of their land.	true
cdir_events_dilemma_choice_details_localised_choice_title_shield_ally_region_vik_reg_domucFIRST	We must honour the rights of our ally and return this land to their king.	true
cdir_events_dilemma_choice_details_localised_choice_title_shield_ally_region_vik_reg_domucSECOND	Our ally will surely be angered by our theft of their land.	true
cdir_events_dilemma_choice_details_localised_choice_title_shield_ally_region_vik_reg_doneceasterFIRST	We must honour the rights of our ally and return this land to their king.	true
cdir_events_dilemma_choice_details_localised_choice_title_shield_ally_region_vik_reg_doneceasterSECOND	Our ally will surely be angered by our theft of their land.	true
cdir_events_dilemma_choice_details_localised_choice_title_shield_ally_region_vik_reg_doreceasterFIRST	We must honour the rights of our ally and return this land to their king.	true
cdir_events_dilemma_choice_details_localised_choice_title_shield_ally_region_vik_reg_doreceasterSECOND	Our ally will surely be angered by our theft of their land.	true
cdir_events_dilemma_choice_details_localised_choice_title_shield_ally_region_vik_reg_dorFIRST	We must honour the rights of our ally and return this land to their king.	true
cdir_events_dilemma_choice_details_localised_choice_title_shield_ally_region_vik_reg_dorSECOND	Our ally will surely be angered by our theft of their land.	true
cdir_events_dilemma_choice_details_localised_choice_title_shield_ally_region_vik_reg_draytonFIRST	We must honour the rights of our ally and return this land to their king.	true
cdir_events_dilemma_choice_details_localised_choice_title_shield_ally_region_vik_reg_draytonSECOND	Our ally will surely be angered by our theft of their land.	true
cdir_events_dilemma_choice_details_localised_choice_title_shield_ally_region_vik_reg_druim_collachairFIRST	We must honour the rights of our ally and return this land to their king.	true
cdir_events_dilemma_choice_details_localised_choice_title_shield_ally_region_vik_reg_druim_collachairSECOND	Our ally will surely be angered by our theft of their land.	true
cdir_events_dilemma_choice_details_localised_choice_title_shield_ally_region_vik_reg_druim_da_ethiarFIRST	We must honour the rights of our ally and return this land to their king.	true
cdir_events_dilemma_choice_details_localised_choice_title_shield_ally_region_vik_reg_druim_da_ethiarSECOND	Our ally will surely be angered by our theft of their land.	true
cdir_events_dilemma_choice_details_localised_choice_title_shield_ally_region_vik_reg_dugannuFIRST	We must honour the rights of our ally and return this land to their king.	true
cdir_events_dilemma_choice_details_localised_choice_title_shield_ally_region_vik_reg_dugannuSECOND	Our ally will surely be angered by our theft of their land.	true
cdir_events_dilemma_choice_details_localised_choice_title_shield_ally_region_vik_reg_dun_aberteFIRST	We must honour the rights of our ally and return this land to their king.	true
cdir_events_dilemma_choice_details_localised_choice_title_shield_ally_region_vik_reg_dun_aberteSECOND	Our ally will surely be angered by our theft of their land.	true
cdir_events_dilemma_choice_details_localised_choice_title_shield_ally_region_vik_reg_dun_attFIRST	We must honour the rights of our ally and return this land to their king.	true
cdir_events_dilemma_choice_details_localised_choice_title_shield_ally_region_vik_reg_dun_attSECOND	Our ally will surely be angered by our theft of their land.	true
cdir_events_dilemma_choice_details_localised_choice_title_shield_ally_region_vik_reg_dun_beccanFIRST	We must honour the rights of our ally and return this land to their king.	true
cdir_events_dilemma_choice_details_localised_choice_title_shield_ally_region_vik_reg_dun_beccanSECOND	Our ally will surely be angered by our theft of their land.	true
cdir_events_dilemma_choice_details_localised_choice_title_shield_ally_region_vik_reg_dun_blannFIRST	We must honour the rights of our ally and return this land to their king.	true
cdir_events_dilemma_choice_details_localised_choice_title_shield_ally_region_vik_reg_dun_blannSECOND	Our ally will surely be angered by our theft of their land.	true
cdir_events_dilemma_choice_details_localised_choice_title_shield_ally_region_vik_reg_dun_caildenFIRST	We must honour the rights of our ally and return this land to their king.	true
cdir_events_dilemma_choice_details_localised_choice_title_shield_ally_region_vik_reg_dun_caildenSECOND	Our ally will surely be angered by our theft of their land.	true
cdir_events_dilemma_choice_details_localised_choice_title_shield_ally_region_vik_reg_dun_domnaillFIRST	We must honour the rights of our ally and return this land to their king.	true
cdir_events_dilemma_choice_details_localised_choice_title_shield_ally_region_vik_reg_dun_domnaillSECOND	Our ally will surely be angered by our theft of their land.	true
cdir_events_dilemma_choice_details_localised_choice_title_shield_ally_region_vik_reg_dun_duirnFIRST	We must honour the rights of our ally and return this land to their king.	true
cdir_events_dilemma_choice_details_localised_choice_title_shield_ally_region_vik_reg_dun_duirnSECOND	Our ally will surely be angered by our theft of their land.	true
cdir_events_dilemma_choice_details_localised_choice_title_shield_ally_region_vik_reg_dun_eachainnFIRST	We must honour the rights of our ally and return this land to their king.	true
cdir_events_dilemma_choice_details_localised_choice_title_shield_ally_region_vik_reg_dun_eachainnSECOND	Our ally will surely be angered by our theft of their land.	true
cdir_events_dilemma_choice_details_localised_choice_title_shield_ally_region_vik_reg_dun_foitherFIRST	We must honour the rights of our ally and return this land to their king.	true
cdir_events_dilemma_choice_details_localised_choice_title_shield_ally_region_vik_reg_dun_foitherSECOND	Our ally will surely be angered by our theft of their land.	true
cdir_events_dilemma_choice_details_localised_choice_title_shield_ally_region_vik_reg_dun_na_ngallFIRST	We must honour the rights of our ally and return this land to their king.	true
cdir_events_dilemma_choice_details_localised_choice_title_shield_ally_region_vik_reg_dun_na_ngallSECOND	Our ally will surely be angered by our theft of their land.	true
cdir_events_dilemma_choice_details_localised_choice_title_shield_ally_region_vik_reg_dun_nechtainFIRST	We must honour the rights of our ally and return this land to their king.	true
cdir_events_dilemma_choice_details_localised_choice_title_shield_ally_region_vik_reg_dun_nechtainSECOND	Our ally will surely be angered by our theft of their land.	true
cdir_events_dilemma_choice_details_localised_choice_title_shield_ally_region_vik_reg_dun_ollaigFIRST	We must honour the rights of our ally and return this land to their king.	true
cdir_events_dilemma_choice_details_localised_choice_title_shield_ally_region_vik_reg_dun_ollaigSECOND	Our ally will surely be angered by our theft of their land.	true
cdir_events_dilemma_choice_details_localised_choice_title_shield_ally_region_vik_reg_dun_patraicFIRST	We must honour the rights of our ally and return this land to their king.	true
cdir_events_dilemma_choice_details_localised_choice_title_shield_ally_region_vik_reg_dun_patraicSECOND	Our ally will surely be angered by our theft of their land.	true
cdir_events_dilemma_choice_details_localised_choice_title_shield_ally_region_vik_reg_dun_sebuirgiFIRST	We must honour the rights of our ally and return this land to their king.	true
cdir_events_dilemma_choice_details_localised_choice_title_shield_ally_region_vik_reg_dun_sebuirgiSECOND	Our ally will surely be angered by our theft of their land.	true
cdir_events_dilemma_choice_details_localised_choice_title_shield_ally_region_vik_reg_dunholmFIRST	We must honour the rights of our ally and return this land to their king.	true
cdir_events_dilemma_choice_details_localised_choice_title_shield_ally_region_vik_reg_dunholmSECOND	Our ally will surely be angered by our theft of their land.	true
cdir_events_dilemma_choice_details_localised_choice_title_shield_ally_region_vik_reg_dyflinFIRST	We must honour the rights of our ally and return this land to their king.	true
cdir_events_dilemma_choice_details_localised_choice_title_shield_ally_region_vik_reg_dyflinSECOND	Our ally will surely be angered by our theft of their land.	true
cdir_events_dilemma_choice_details_localised_choice_title_shield_ally_region_vik_reg_dynbaerFIRST	We must honour the rights of our ally and return this land to their king.	true
cdir_events_dilemma_choice_details_localised_choice_title_shield_ally_region_vik_reg_dynbaerSECOND	Our ally will surely be angered by our theft of their land.	true
cdir_events_dilemma_choice_details_localised_choice_title_shield_ally_region_vik_reg_earmuthaFIRST	We must honour the rights of our ally and return this land to their king.	true
cdir_events_dilemma_choice_details_localised_choice_title_shield_ally_region_vik_reg_earmuthaSECOND	Our ally will surely be angered by our theft of their land.	true
cdir_events_dilemma_choice_details_localised_choice_title_shield_ally_region_vik_reg_ebbeshamFIRST	We must honour the rights of our ally and return this land to their king.	true
cdir_events_dilemma_choice_details_localised_choice_title_shield_ally_region_vik_reg_ebbeshamSECOND	Our ally will surely be angered by our theft of their land.	true
cdir_events_dilemma_choice_details_localised_choice_title_shield_ally_region_vik_reg_eidenburgFIRST	We must honour the rights of our ally and return this land to their king.	true
cdir_events_dilemma_choice_details_localised_choice_title_shield_ally_region_vik_reg_eidenburgSECOND	Our ally will surely be angered by our theft of their land.	true
cdir_events_dilemma_choice_details_localised_choice_title_shield_ally_region_vik_reg_eligFIRST	We must honour the rights of our ally and return this land to their king.	true
cdir_events_dilemma_choice_details_localised_choice_title_shield_ally_region_vik_reg_eligSECOND	Our ally will surely be angered by our theft of their land.	true
cdir_events_dilemma_choice_details_localised_choice_title_shield_ally_region_vik_reg_eoferwicFIRST	We must honour the rights of our ally and return this land to their king.	true
cdir_events_dilemma_choice_details_localised_choice_title_shield_ally_region_vik_reg_eoferwicSECOND	Our ally will surely be angered by our theft of their land.	true
cdir_events_dilemma_choice_details_localised_choice_title_shield_ally_region_vik_reg_eofeshamFIRST	We must honour the rights of our ally and return this land to their king.	true
cdir_events_dilemma_choice_details_localised_choice_title_shield_ally_region_vik_reg_eofeshamSECOND	Our ally will surely be angered by our theft of their land.	true
cdir_events_dilemma_choice_details_localised_choice_title_shield_ally_region_vik_reg_ethandunFIRST	We must honour the rights of our ally and return this land to their king.	true
cdir_events_dilemma_choice_details_localised_choice_title_shield_ally_region_vik_reg_ethandunSECOND	Our ally will surely be angered by our theft of their land.	true
cdir_events_dilemma_choice_details_localised_choice_title_shield_ally_region_vik_reg_exanceasterFIRST	We must honour the rights of our ally and return this land to their king.	true
cdir_events_dilemma_choice_details_localised_choice_title_shield_ally_region_vik_reg_exanceasterSECOND	Our ally will surely be angered by our theft of their land.	true
cdir_events_dilemma_choice_details_localised_choice_title_shield_ally_region_vik_reg_fernaFIRST	We must honour the rights of our ally and return this land to their king.	true
cdir_events_dilemma_choice_details_localised_choice_title_shield_ally_region_vik_reg_fernaSECOND	Our ally will surely be angered by our theft of their land.	true
cdir_events_dilemma_choice_details_localised_choice_title_shield_ally_region_vik_reg_flichesburgFIRST	We must honour the rights of our ally and return this land to their king.	true
cdir_events_dilemma_choice_details_localised_choice_title_shield_ally_region_vik_reg_flichesburgSECOND	Our ally will surely be angered by our theft of their land.	true
cdir_events_dilemma_choice_details_localised_choice_title_shield_ally_region_vik_reg_foraisFIRST	We must honour the rights of our ally and return this land to their king.	true
cdir_events_dilemma_choice_details_localised_choice_title_shield_ally_region_vik_reg_foraisSECOND	Our ally will surely be angered by our theft of their land.	true
cdir_events_dilemma_choice_details_localised_choice_title_shield_ally_region_vik_reg_gipeswicFIRST	We must honour the rights of our ally and return this land to their king.	true
cdir_events_dilemma_choice_details_localised_choice_title_shield_ally_region_vik_reg_gipeswicSECOND	Our ally will surely be angered by our theft of their land.	true
cdir_events_dilemma_choice_details_localised_choice_title_shield_ally_region_vik_reg_glastingburiFIRST	We must honour the rights of our ally and return this land to their king.	true
cdir_events_dilemma_choice_details_localised_choice_title_shield_ally_region_vik_reg_glastingburiSECOND	Our ally will surely be angered by our theft of their land.	true
cdir_events_dilemma_choice_details_localised_choice_title_shield_ally_region_vik_reg_gleann_da_lochFIRST	We must honour the rights of our ally and return this land to their king.	true
cdir_events_dilemma_choice_details_localised_choice_title_shield_ally_region_vik_reg_gleann_da_lochSECOND	Our ally will surely be angered by our theft of their land.	true
cdir_events_dilemma_choice_details_localised_choice_title_shield_ally_region_vik_reg_gleawceasterFIRST	We must honour the rights of our ally and return this land to their king.	true
cdir_events_dilemma_choice_details_localised_choice_title_shield_ally_region_vik_reg_gleawceasterSECOND	Our ally will surely be angered by our theft of their land.	true
cdir_events_dilemma_choice_details_localised_choice_title_shield_ally_region_vik_reg_grantabrycgFIRST	We must honour the rights of our ally and return this land to their king.	true
cdir_events_dilemma_choice_details_localised_choice_title_shield_ally_region_vik_reg_grantabrycgSECOND	Our ally will surely be angered by our theft of their land.	true
cdir_events_dilemma_choice_details_localised_choice_title_shield_ally_region_vik_reg_grianan_aileachFIRST	We must honour the rights of our ally and return this land to their king.	true
cdir_events_dilemma_choice_details_localised_choice_title_shield_ally_region_vik_reg_grianan_aileachSECOND	Our ally will surely be angered by our theft of their land.	true
cdir_events_dilemma_choice_details_localised_choice_title_shield_ally_region_vik_reg_guldefordFIRST	We must honour the rights of our ally and return this land to their king.	true
cdir_events_dilemma_choice_details_localised_choice_title_shield_ally_region_vik_reg_guldefordSECOND	Our ally will surely be angered by our theft of their land.	true
cdir_events_dilemma_choice_details_localised_choice_title_shield_ally_region_vik_reg_guvanFIRST	We must honour the rights of our ally and return this land to their king.	true
cdir_events_dilemma_choice_details_localised_choice_title_shield_ally_region_vik_reg_guvanSECOND	Our ally will surely be angered by our theft of their land.	true
cdir_events_dilemma_choice_details_localised_choice_title_shield_ally_region_vik_reg_gyruumFIRST	We must honour the rights of our ally and return this land to their king.	true
cdir_events_dilemma_choice_details_localised_choice_title_shield_ally_region_vik_reg_gyruumSECOND	Our ally will surely be angered by our theft of their land.	true
cdir_events_dilemma_choice_details_localised_choice_title_shield_ally_region_vik_reg_haestingasFIRST	We must honour the rights of our ally and return this land to their king.	true
cdir_events_dilemma_choice_details_localised_choice_title_shield_ally_region_vik_reg_haestingasSECOND	Our ally will surely be angered by our theft of their land.	true
cdir_events_dilemma_choice_details_localised_choice_title_shield_ally_region_vik_reg_hagustaldesFIRST	We must honour the rights of our ally and return this land to their king.	true
cdir_events_dilemma_choice_details_localised_choice_title_shield_ally_region_vik_reg_hagustaldesSECOND	Our ally will surely be angered by our theft of their land.	true
cdir_events_dilemma_choice_details_localised_choice_title_shield_ally_region_vik_reg_haverfordiaFIRST	We must honour the rights of our ally and return this land to their king.	true
cdir_events_dilemma_choice_details_localised_choice_title_shield_ally_region_vik_reg_haverfordiaSECOND	Our ally will surely be angered by our theft of their land.	true
cdir_events_dilemma_choice_details_localised_choice_title_shield_ally_region_vik_reg_herefordFIRST	We must honour the rights of our ally and return this land to their king.	true
cdir_events_dilemma_choice_details_localised_choice_title_shield_ally_region_vik_reg_herefordSECOND	Our ally will surely be angered by our theft of their land.	true
cdir_events_dilemma_choice_details_localised_choice_title_shield_ally_region_vik_reg_herutfordFIRST	We must honour the rights of our ally and return this land to their king.	true
cdir_events_dilemma_choice_details_localised_choice_title_shield_ally_region_vik_reg_herutfordSECOND	Our ally will surely be angered by our theft of their land.	true
cdir_events_dilemma_choice_details_localised_choice_title_shield_ally_region_vik_reg_heslertonFIRST	We must honour the rights of our ally and return this land to their king.	true
cdir_events_dilemma_choice_details_localised_choice_title_shield_ally_region_vik_reg_heslertonSECOND	Our ally will surely be angered by our theft of their land.	true
cdir_events_dilemma_choice_details_localised_choice_title_shield_ally_region_vik_reg_hlymrekrFIRST	We must honour the rights of our ally and return this land to their king.	true
cdir_events_dilemma_choice_details_localised_choice_title_shield_ally_region_vik_reg_hlymrekrSECOND	Our ally will surely be angered by our theft of their land.	true
cdir_events_dilemma_choice_details_localised_choice_title_shield_ally_region_vik_reg_hripumFIRST	We must honour the rights of our ally and return this land to their king.	true
cdir_events_dilemma_choice_details_localised_choice_title_shield_ally_region_vik_reg_hripumSECOND	Our ally will surely be angered by our theft of their land.	true
cdir_events_dilemma_choice_details_localised_choice_title_shield_ally_region_vik_reg_huntandunFIRST	We must honour the rights of our ally and return this land to their king.	true
cdir_events_dilemma_choice_details_localised_choice_title_shield_ally_region_vik_reg_huntandunSECOND	Our ally will surely be angered by our theft of their land.	true
cdir_events_dilemma_choice_details_localised_choice_title_shield_ally_region_vik_reg_hwitan_aerneFIRST	We must honour the rights of our ally and return this land to their king.	true
cdir_events_dilemma_choice_details_localised_choice_title_shield_ally_region_vik_reg_hwitan_aerneSECOND	Our ally will surely be angered by our theft of their land.	true
cdir_events_dilemma_choice_details_localised_choice_title_shield_ally_region_vik_reg_imblech_ibairFIRST	We must honour the rights of our ally and return this land to their king.	true
cdir_events_dilemma_choice_details_localised_choice_title_shield_ally_region_vik_reg_imblech_ibairSECOND	Our ally will surely be angered by our theft of their land.	true
cdir_events_dilemma_choice_details_localised_choice_title_shield_ally_region_vik_reg_inber_niseFIRST	We must honour the rights of our ally and return this land to their king.	true
cdir_events_dilemma_choice_details_localised_choice_title_shield_ally_region_vik_reg_inber_niseSECOND	Our ally will surely be angered by our theft of their land.	true
cdir_events_dilemma_choice_details_localised_choice_title_shield_ally_region_vik_reg_inis_cathaighFIRST	We must honour the rights of our ally and return this land to their king.	true
cdir_events_dilemma_choice_details_localised_choice_title_shield_ally_region_vik_reg_inis_cathaighSECOND	Our ally will surely be angered by our theft of their land.	true
cdir_events_dilemma_choice_details_localised_choice_title_shield_ally_region_vik_reg_inis_faithlennFIRST	We must honour the rights of our ally and return this land to their king.	true
cdir_events_dilemma_choice_details_localised_choice_title_shield_ally_region_vik_reg_inis_faithlennSECOND	Our ally will surely be angered by our theft of their land.	true
cdir_events_dilemma_choice_details_localised_choice_title_shield_ally_region_vik_reg_inis_patraicFIRST	We must honour the rights of our ally and return this land to their king.	true
cdir_events_dilemma_choice_details_localised_choice_title_shield_ally_region_vik_reg_inis_patraicSECOND	Our ally will surely be angered by our theft of their land.	true
cdir_events_dilemma_choice_details_localised_choice_title_shield_ally_region_vik_reg_iouaFIRST	We must honour the rights of our ally and return this land to their king.	true
cdir_events_dilemma_choice_details_localised_choice_title_shield_ally_region_vik_reg_iouaSECOND	Our ally will surely be angered by our theft of their land.	true
cdir_events_dilemma_choice_details_localised_choice_title_shield_ally_region_vik_reg_laeweFIRST	We must honour the rights of our ally and return this land to their king.	true
cdir_events_dilemma_choice_details_localised_choice_title_shield_ally_region_vik_reg_laeweSECOND	Our ally will surely be angered by our theft of their land.	true
cdir_events_dilemma_choice_details_localised_choice_title_shield_ally_region_vik_reg_lann_afanFIRST	We must honour the rights of our ally and return this land to their king.	true
cdir_events_dilemma_choice_details_localised_choice_title_shield_ally_region_vik_reg_lann_afanSECOND	Our ally will surely be angered by our theft of their land.	true
cdir_events_dilemma_choice_details_localised_choice_title_shield_ally_region_vik_reg_lann_corsFIRST	We must honour the rights of our ally and return this land to their king.	true
cdir_events_dilemma_choice_details_localised_choice_title_shield_ally_region_vik_reg_lann_corsSECOND	Our ally will surely be angered by our theft of their land.	true
cdir_events_dilemma_choice_details_localised_choice_title_shield_ally_region_vik_reg_lann_dewiFIRST	We must honour the rights of our ally and return this land to their king.	true
cdir_events_dilemma_choice_details_localised_choice_title_shield_ally_region_vik_reg_lann_dewiSECOND	Our ally will surely be angered by our theft of their land.	true
cdir_events_dilemma_choice_details_localised_choice_title_shield_ally_region_vik_reg_lann_idloesFIRST	We must honour the rights of our ally and return this land to their king.	true
cdir_events_dilemma_choice_details_localised_choice_title_shield_ally_region_vik_reg_lann_idloesSECOND	Our ally will surely be angered by our theft of their land.	true
cdir_events_dilemma_choice_details_localised_choice_title_shield_ally_region_vik_reg_lann_ildutFIRST	We must honour the rights of our ally and return this land to their king.	true
cdir_events_dilemma_choice_details_localised_choice_title_shield_ally_region_vik_reg_lann_ildutSECOND	Our ally will surely be angered by our theft of their land.	true
cdir_events_dilemma_choice_details_localised_choice_title_shield_ally_region_vik_reg_lann_padarnFIRST	We must honour the rights of our ally and return this land to their king.	true
cdir_events_dilemma_choice_details_localised_choice_title_shield_ally_region_vik_reg_lann_padarnSECOND	Our ally will surely be angered by our theft of their land.	true
cdir_events_dilemma_choice_details_localised_choice_title_shield_ally_region_vik_reg_latharnaFIRST	We must honour the rights of our ally and return this land to their king.	true
cdir_events_dilemma_choice_details_localised_choice_title_shield_ally_region_vik_reg_latharnaSECOND	Our ally will surely be angered by our theft of their land.	true
cdir_events_dilemma_choice_details_localised_choice_title_shield_ally_region_vik_reg_latharnFIRST	We must honour the rights of our ally and return this land to their king.	true
cdir_events_dilemma_choice_details_localised_choice_title_shield_ally_region_vik_reg_latharnSECOND	Our ally will surely be angered by our theft of their land.	true
cdir_events_dilemma_choice_details_localised_choice_title_shield_ally_region_vik_reg_licetfeldaFIRST	We must honour the rights of our ally and return this land to their king.	true
cdir_events_dilemma_choice_details_localised_choice_title_shield_ally_region_vik_reg_licetfeldaSECOND	Our ally will surely be angered by our theft of their land.	true
cdir_events_dilemma_choice_details_localised_choice_title_shield_ally_region_vik_reg_ligeraceasterFIRST	We must honour the rights of our ally and return this land to their king.	true
cdir_events_dilemma_choice_details_localised_choice_title_shield_ally_region_vik_reg_ligeraceasterSECOND	Our ally will surely be angered by our theft of their land.	true
cdir_events_dilemma_choice_details_localised_choice_title_shield_ally_region_vik_reg_lindcylneFIRST	We must honour the rights of our ally and return this land to their king.	true
cdir_events_dilemma_choice_details_localised_choice_title_shield_ally_region_vik_reg_lindcylneSECOND	Our ally will surely be angered by our theft of their land.	true
cdir_events_dilemma_choice_details_localised_choice_title_shield_ally_region_vik_reg_linnsFIRST	We must honour the rights of our ally and return this land to their king.	true
cdir_events_dilemma_choice_details_localised_choice_title_shield_ally_region_vik_reg_linnsSECOND	Our ally will surely be angered by our theft of their land.	true
cdir_events_dilemma_choice_details_localised_choice_title_shield_ally_region_vik_reg_lis_morFIRST	We must honour the rights of our ally and return this land to their king.	true
cdir_events_dilemma_choice_details_localised_choice_title_shield_ally_region_vik_reg_lis_morSECOND	Our ally will surely be angered by our theft of their land.	true
cdir_events_dilemma_choice_details_localised_choice_title_shield_ally_region_vik_reg_liwtuneFIRST	We must honour the rights of our ally and return this land to their king.	true
cdir_events_dilemma_choice_details_localised_choice_title_shield_ally_region_vik_reg_liwtuneSECOND	Our ally will surely be angered by our theft of their land.	true
cdir_events_dilemma_choice_details_localised_choice_title_shield_ally_region_vik_reg_loch_gabhairFIRST	We must honour the rights of our ally and return this land to their king.	true
cdir_events_dilemma_choice_details_localised_choice_title_shield_ally_region_vik_reg_loch_gabhairSECOND	Our ally will surely be angered by our theft of their land.	true
cdir_events_dilemma_choice_details_localised_choice_title_shield_ally_region_vik_reg_loch_raichFIRST	We must honour the rights of our ally and return this land to their king.	true
cdir_events_dilemma_choice_details_localised_choice_title_shield_ally_region_vik_reg_loch_raichSECOND	Our ally will surely be angered by our theft of their land.	true
cdir_events_dilemma_choice_details_localised_choice_title_shield_ally_region_vik_reg_loidisFIRST	We must honour the rights of our ally and return this land to their king.	true
cdir_events_dilemma_choice_details_localised_choice_title_shield_ally_region_vik_reg_loidisSECOND	Our ally will surely be angered by our theft of their land.	true
cdir_events_dilemma_choice_details_localised_choice_title_shield_ally_region_vik_reg_lonceasterFIRST	We must honour the rights of our ally and return this land to their king.	true
cdir_events_dilemma_choice_details_localised_choice_title_shield_ally_region_vik_reg_lonceasterSECOND	Our ally will surely be angered by our theft of their land.	true
cdir_events_dilemma_choice_details_localised_choice_title_shield_ally_region_vik_reg_ludeFIRST	We must honour the rights of our ally and return this land to their king.	true
cdir_events_dilemma_choice_details_localised_choice_title_shield_ally_region_vik_reg_ludeSECOND	Our ally will surely be angered by our theft of their land.	true
cdir_events_dilemma_choice_details_localised_choice_title_shield_ally_region_vik_reg_lundenFIRST	We must honour the rights of our ally and return this land to their king.	true
cdir_events_dilemma_choice_details_localised_choice_title_shield_ally_region_vik_reg_lundenSECOND	Our ally will surely be angered by our theft of their land.	true
cdir_events_dilemma_choice_details_localised_choice_title_shield_ally_region_vik_reg_maelduneFIRST	We must honour the rights of our ally and return this land to their king.	true
cdir_events_dilemma_choice_details_localised_choice_title_shield_ally_region_vik_reg_maelduneSECOND	Our ally will surely be angered by our theft of their land.	true
cdir_events_dilemma_choice_details_localised_choice_title_shield_ally_region_vik_reg_mailrosFIRST	We must honour the rights of our ally and return this land to their king.	true
cdir_events_dilemma_choice_details_localised_choice_title_shield_ally_region_vik_reg_mailrosSECOND	Our ally will surely be angered by our theft of their land.	true
cdir_events_dilemma_choice_details_localised_choice_title_shield_ally_region_vik_reg_mameceasterFIRST	We must honour the rights of our ally and return this land to their king.	true
cdir_events_dilemma_choice_details_localised_choice_title_shield_ally_region_vik_reg_mameceasterSECOND	Our ally will surely be angered by our theft of their land.	true
cdir_events_dilemma_choice_details_localised_choice_title_shield_ally_region_vik_reg_mathrafalFIRST	We must honour the rights of our ally and return this land to their king.	true
cdir_events_dilemma_choice_details_localised_choice_title_shield_ally_region_vik_reg_mathrafalSECOND	Our ally will surely be angered by our theft of their land.	true
cdir_events_dilemma_choice_details_localised_choice_title_shield_ally_region_vik_reg_meneviaFIRST	We must honour the rights of our ally and return this land to their king.	true
cdir_events_dilemma_choice_details_localised_choice_title_shield_ally_region_vik_reg_meneviaSECOND	Our ally will surely be angered by our theft of their land.	true
cdir_events_dilemma_choice_details_localised_choice_title_shield_ally_region_vik_reg_middeherstFIRST	We must honour the rights of our ally and return this land to their king.	true
cdir_events_dilemma_choice_details_localised_choice_title_shield_ally_region_vik_reg_middeherstSECOND	Our ally will surely be angered by our theft of their land.	true
cdir_events_dilemma_choice_details_localised_choice_title_shield_ally_region_vik_reg_moige_bileFIRST	We must honour the rights of our ally and return this land to their king.	true
cdir_events_dilemma_choice_details_localised_choice_title_shield_ally_region_vik_reg_moige_bileSECOND	Our ally will surely be angered by our theft of their land.	true
cdir_events_dilemma_choice_details_localised_choice_title_shield_ally_region_vik_reg_na_seciriFIRST	We must honour the rights of our ally and return this land to their king.	true
cdir_events_dilemma_choice_details_localised_choice_title_shield_ally_region_vik_reg_na_seciriSECOND	Our ally will surely be angered by our theft of their land.	true
cdir_events_dilemma_choice_details_localised_choice_title_shield_ally_region_vik_reg_nasFIRST	We must honour the rights of our ally and return this land to their king.	true
cdir_events_dilemma_choice_details_localised_choice_title_shield_ally_region_vik_reg_nasSECOND	Our ally will surely be angered by our theft of their land.	true
cdir_events_dilemma_choice_details_localised_choice_title_shield_ally_region_vik_reg_neddFIRST	We must honour the rights of our ally and return this land to their king.	true
cdir_events_dilemma_choice_details_localised_choice_title_shield_ally_region_vik_reg_neddSECOND	Our ally will surely be angered by our theft of their land.	true
cdir_events_dilemma_choice_details_localised_choice_title_shield_ally_region_vik_reg_northhamtunFIRST	We must honour the rights of our ally and return this land to their king.	true
cdir_events_dilemma_choice_details_localised_choice_title_shield_ally_region_vik_reg_northhamtunSECOND	Our ally will surely be angered by our theft of their land.	true
cdir_events_dilemma_choice_details_localised_choice_title_shield_ally_region_vik_reg_northwicFIRST	We must honour the rights of our ally and return this land to their king.	true
cdir_events_dilemma_choice_details_localised_choice_title_shield_ally_region_vik_reg_northwicSECOND	Our ally will surely be angered by our theft of their land.	true
cdir_events_dilemma_choice_details_localised_choice_title_shield_ally_region_vik_reg_oswaldestroeFIRST	We must honour the rights of our ally and return this land to their king.	true
cdir_events_dilemma_choice_details_localised_choice_title_shield_ally_region_vik_reg_oswaldestroeSECOND	Our ally will surely be angered by our theft of their land.	true
cdir_events_dilemma_choice_details_localised_choice_title_shield_ally_region_vik_reg_otergimeleFIRST	We must honour the rights of our ally and return this land to their king.	true
cdir_events_dilemma_choice_details_localised_choice_title_shield_ally_region_vik_reg_otergimeleSECOND	Our ally will surely be angered by our theft of their land.	true
cdir_events_dilemma_choice_details_localised_choice_title_shield_ally_region_vik_reg_oxnafordaFIRST	We must honour the rights of our ally and return this land to their king.	true
cdir_events_dilemma_choice_details_localised_choice_title_shield_ally_region_vik_reg_oxnafordaSECOND	Our ally will surely be angered by our theft of their land.	true
cdir_events_dilemma_choice_details_localised_choice_title_shield_ally_region_vik_reg_pefeneseaFIRST	We must honour the rights of our ally and return this land to their king.	true
cdir_events_dilemma_choice_details_localised_choice_title_shield_ally_region_vik_reg_pefeneseaSECOND	Our ally will surely be angered by our theft of their land.	true
cdir_events_dilemma_choice_details_localised_choice_title_shield_ally_region_vik_reg_poclintunFIRST	We must honour the rights of our ally and return this land to their king.	true
cdir_events_dilemma_choice_details_localised_choice_title_shield_ally_region_vik_reg_poclintunSECOND	Our ally will surely be angered by our theft of their land.	true
cdir_events_dilemma_choice_details_localised_choice_title_shield_ally_region_vik_reg_porteceasterFIRST	We must honour the rights of our ally and return this land to their king.	true
cdir_events_dilemma_choice_details_localised_choice_title_shield_ally_region_vik_reg_porteceasterSECOND	Our ally will surely be angered by our theft of their land.	true
cdir_events_dilemma_choice_details_localised_choice_title_shield_ally_region_vik_reg_rath_cruachanFIRST	We must honour the rights of our ally and return this land to their king.	true
cdir_events_dilemma_choice_details_localised_choice_title_shield_ally_region_vik_reg_rath_cruachanSECOND	Our ally will surely be angered by our theft of their land.	true
cdir_events_dilemma_choice_details_localised_choice_title_shield_ally_region_vik_reg_rath_luraigFIRST	We must honour the rights of our ally and return this land to their king.	true
cdir_events_dilemma_choice_details_localised_choice_title_shield_ally_region_vik_reg_rath_luraigSECOND	Our ally will surely be angered by our theft of their land.	true
cdir_events_dilemma_choice_details_localised_choice_title_shield_ally_region_vik_reg_rendleshamFIRST	We must honour the rights of our ally and return this land to their king.	true
cdir_events_dilemma_choice_details_localised_choice_title_shield_ally_region_vik_reg_rendleshamSECOND	Our ally will surely be angered by our theft of their land.	true
cdir_events_dilemma_choice_details_localised_choice_title_shield_ally_region_vik_reg_rinninFIRST	We must honour the rights of our ally and return this land to their king.	true
cdir_events_dilemma_choice_details_localised_choice_title_shield_ally_region_vik_reg_rinninSECOND	Our ally will surely be angered by our theft of their land.	true
cdir_events_dilemma_choice_details_localised_choice_title_shield_ally_region_vik_reg_rocheberieFIRST	We must honour the rights of our ally and return this land to their king.	true
cdir_events_dilemma_choice_details_localised_choice_title_shield_ally_region_vik_reg_rocheberieSECOND	Our ally will surely be angered by our theft of their land.	true
cdir_events_dilemma_choice_details_localised_choice_title_shield_ally_region_vik_reg_rofeceasterFIRST	We must honour the rights of our ally and return this land to their king.	true
cdir_events_dilemma_choice_details_localised_choice_title_shield_ally_region_vik_reg_rofeceasterSECOND	Our ally will surely be angered by our theft of their land.	true
cdir_events_dilemma_choice_details_localised_choice_title_shield_ally_region_vik_reg_ros_ailithirFIRST	We must honour the rights of our ally and return this land to their king.	true
cdir_events_dilemma_choice_details_localised_choice_title_shield_ally_region_vik_reg_ros_ailithirSECOND	Our ally will surely be angered by our theft of their land.	true
cdir_events_dilemma_choice_details_localised_choice_title_shield_ally_region_vik_reg_ros_cuissineFIRST	We must honour the rights of our ally and return this land to their king.	true
cdir_events_dilemma_choice_details_localised_choice_title_shield_ally_region_vik_reg_ros_cuissineSECOND	Our ally will surely be angered by our theft of their land.	true
cdir_events_dilemma_choice_details_localised_choice_title_shield_ally_region_vik_reg_ros_maircindFIRST	We must honour the rights of our ally and return this land to their king.	true
cdir_events_dilemma_choice_details_localised_choice_title_shield_ally_region_vik_reg_ros_maircindSECOND	Our ally will surely be angered by our theft of their land.	true
cdir_events_dilemma_choice_details_localised_choice_title_shield_ally_region_vik_reg_rosFIRST	We must honour the rights of our ally and return this land to their king.	true
cdir_events_dilemma_choice_details_localised_choice_title_shield_ally_region_vik_reg_rosSECOND	Our ally will surely be angered by our theft of their land.	true
cdir_events_dilemma_choice_details_localised_choice_title_shield_ally_region_vik_reg_rucestrFIRST	We must honour the rights of our ally and return this land to their king.	true
cdir_events_dilemma_choice_details_localised_choice_title_shield_ally_region_vik_reg_rucestrSECOND	Our ally will surely be angered by our theft of their land.	true
cdir_events_dilemma_choice_details_localised_choice_title_shield_ally_region_vik_reg_rudglannFIRST	We must honour the rights of our ally and return this land to their king.	true
cdir_events_dilemma_choice_details_localised_choice_title_shield_ally_region_vik_reg_rudglannSECOND	Our ally will surely be angered by our theft of their land.	true
cdir_events_dilemma_choice_details_localised_choice_title_shield_ally_region_vik_reg_saigherFIRST	We must honour the rights of our ally and return this land to their king.	true
cdir_events_dilemma_choice_details_localised_choice_title_shield_ally_region_vik_reg_saigherSECOND	Our ally will surely be angered by our theft of their land.	true
cdir_events_dilemma_choice_details_localised_choice_title_shield_ally_region_vik_reg_sancte_albanesFIRST	We must honour the rights of our ally and return this land to their king.	true
cdir_events_dilemma_choice_details_localised_choice_title_shield_ally_region_vik_reg_sancte_albanesSECOND	Our ally will surely be angered by our theft of their land.	true
cdir_events_dilemma_choice_details_localised_choice_title_shield_ally_region_vik_reg_sancte_eadmundesFIRST	We must honour the rights of our ally and return this land to their king.	true
cdir_events_dilemma_choice_details_localised_choice_title_shield_ally_region_vik_reg_sancte_eadmundesSECOND	Our ally will surely be angered by our theft of their land.	true
cdir_events_dilemma_choice_details_localised_choice_title_shield_ally_region_vik_reg_sancte_germanesFIRST	We must honour the rights of our ally and return this land to their king.	true
cdir_events_dilemma_choice_details_localised_choice_title_shield_ally_region_vik_reg_sancte_germanesSECOND	Our ally will surely be angered by our theft of their land.	true
cdir_events_dilemma_choice_details_localised_choice_title_shield_ally_region_vik_reg_sancte_yeFIRST	We must honour the rights of our ally and return this land to their king.	true
cdir_events_dilemma_choice_details_localised_choice_title_shield_ally_region_vik_reg_sancte_yeSECOND	Our ally will surely be angered by our theft of their land.	true
cdir_events_dilemma_choice_details_localised_choice_title_shield_ally_region_vik_reg_sceaftesburgFIRST	We must honour the rights of our ally and return this land to their king.	true
cdir_events_dilemma_choice_details_localised_choice_title_shield_ally_region_vik_reg_sceaftesburgSECOND	Our ally will surely be angered by our theft of their land.	true
cdir_events_dilemma_choice_details_localised_choice_title_shield_ally_region_vik_reg_scireburnanFIRST	We must honour the rights of our ally and return this land to their king.	true
cdir_events_dilemma_choice_details_localised_choice_title_shield_ally_region_vik_reg_scireburnanSECOND	Our ally will surely be angered by our theft of their land.	true
cdir_events_dilemma_choice_details_localised_choice_title_shield_ally_region_vik_reg_scoanFIRST	We must honour the rights of our ally and return this land to their king.	true
cdir_events_dilemma_choice_details_localised_choice_title_shield_ally_region_vik_reg_scoanSECOND	Our ally will surely be angered by our theft of their land.	true
cdir_events_dilemma_choice_details_localised_choice_title_shield_ally_region_vik_reg_sconninFIRST	We must honour the rights of our ally and return this land to their king.	true
cdir_events_dilemma_choice_details_localised_choice_title_shield_ally_region_vik_reg_sconninSECOND	Our ally will surely be angered by our theft of their land.	true
cdir_events_dilemma_choice_details_localised_choice_title_shield_ally_region_vik_reg_scrobbesburgFIRST	We must honour the rights of our ally and return this land to their king.	true
cdir_events_dilemma_choice_details_localised_choice_title_shield_ally_region_vik_reg_scrobbesburgSECOND	Our ally will surely be angered by our theft of their land.	true
cdir_events_dilemma_choice_details_localised_choice_title_shield_ally_region_vik_reg_seolesiggeFIRST	We must honour the rights of our ally and return this land to their king.	true
cdir_events_dilemma_choice_details_localised_choice_title_shield_ally_region_vik_reg_seolesiggeSECOND	Our ally will surely be angered by our theft of their land.	true
cdir_events_dilemma_choice_details_localised_choice_title_shield_ally_region_vik_reg_snotingahamFIRST	We must honour the rights of our ally and return this land to their king.	true
cdir_events_dilemma_choice_details_localised_choice_title_shield_ally_region_vik_reg_snotingahamSECOND	Our ally will surely be angered by our theft of their land.	true
cdir_events_dilemma_choice_details_localised_choice_title_shield_ally_region_vik_reg_sreth_belinFIRST	We must honour the rights of our ally and return this land to their king.	true
cdir_events_dilemma_choice_details_localised_choice_title_shield_ally_region_vik_reg_sreth_belinSECOND	Our ally will surely be angered by our theft of their land.	true
cdir_events_dilemma_choice_details_localised_choice_title_shield_ally_region_vik_reg_staeffordFIRST	We must honour the rights of our ally and return this land to their king.	true
cdir_events_dilemma_choice_details_localised_choice_title_shield_ally_region_vik_reg_staeffordSECOND	Our ally will surely be angered by our theft of their land.	true
cdir_events_dilemma_choice_details_localised_choice_title_shield_ally_region_vik_reg_staeningumFIRST	We must honour the rights of our ally and return this land to their king.	true
cdir_events_dilemma_choice_details_localised_choice_title_shield_ally_region_vik_reg_staeningumSECOND	Our ally will surely be angered by our theft of their land.	true
cdir_events_dilemma_choice_details_localised_choice_title_shield_ally_region_vik_reg_steanfordFIRST	We must honour the rights of our ally and return this land to their king.	true
cdir_events_dilemma_choice_details_localised_choice_title_shield_ally_region_vik_reg_steanfordSECOND	Our ally will surely be angered by our theft of their land.	true
cdir_events_dilemma_choice_details_localised_choice_title_shield_ally_region_vik_reg_stocFIRST	We must honour the rights of our ally and return this land to their king.	true
cdir_events_dilemma_choice_details_localised_choice_title_shield_ally_region_vik_reg_stocSECOND	Our ally will surely be angered by our theft of their land.	true
cdir_events_dilemma_choice_details_localised_choice_title_shield_ally_region_vik_reg_stornochwayFIRST	We must honour the rights of our ally and return this land to their king.	true
cdir_events_dilemma_choice_details_localised_choice_title_shield_ally_region_vik_reg_stornochwaySECOND	Our ally will surely be angered by our theft of their land.	true
cdir_events_dilemma_choice_details_localised_choice_title_shield_ally_region_vik_reg_stutfallFIRST	We must honour the rights of our ally and return this land to their king.	true
cdir_events_dilemma_choice_details_localised_choice_title_shield_ally_region_vik_reg_stutfallSECOND	Our ally will surely be angered by our theft of their land.	true
cdir_events_dilemma_choice_details_localised_choice_title_shield_ally_region_vik_reg_suthhamtunFIRST	We must honour the rights of our ally and return this land to their king.	true
cdir_events_dilemma_choice_details_localised_choice_title_shield_ally_region_vik_reg_suthhamtunSECOND	Our ally will surely be angered by our theft of their land.	true
cdir_events_dilemma_choice_details_localised_choice_title_shield_ally_region_vik_reg_tamworthigeFIRST	We must honour the rights of our ally and return this land to their king.	true
cdir_events_dilemma_choice_details_localised_choice_title_shield_ally_region_vik_reg_tamworthigeSECOND	Our ally will surely be angered by our theft of their land.	true
cdir_events_dilemma_choice_details_localised_choice_title_shield_ally_region_vik_reg_tanetFIRST	We must honour the rights of our ally and return this land to their king.	true
cdir_events_dilemma_choice_details_localised_choice_title_shield_ally_region_vik_reg_tanetSECOND	Our ally will surely be angered by our theft of their land.	true
cdir_events_dilemma_choice_details_localised_choice_title_shield_ally_region_vik_reg_terra_incognitaFIRST	We must honour the rights of our ally and return this land to their king.	true
cdir_events_dilemma_choice_details_localised_choice_title_shield_ally_region_vik_reg_terra_incognitaSECOND	Our ally will surely be angered by our theft of their land.	true
cdir_events_dilemma_choice_details_localised_choice_title_shield_ally_region_vik_reg_theodfordFIRST	We must honour the rights of our ally and return this land to their king.	true
cdir_events_dilemma_choice_details_localised_choice_title_shield_ally_region_vik_reg_theodfordSECOND	Our ally will surely be angered by our theft of their land.	true
cdir_events_dilemma_choice_details_localised_choice_title_shield_ally_region_vik_reg_thursaFIRST	We must honour the rights of our ally and return this land to their king.	true
cdir_events_dilemma_choice_details_localised_choice_title_shield_ally_region_vik_reg_thursaSECOND	Our ally will surely be angered by our theft of their land.	true
cdir_events_dilemma_choice_details_localised_choice_title_shield_ally_region_vik_reg_tilaburgFIRST	We must honour the rights of our ally and return this land to their king.	true
cdir_events_dilemma_choice_details_localised_choice_title_shield_ally_region_vik_reg_tilaburgSECOND	Our ally will surely be angered by our theft of their land.	true
cdir_events_dilemma_choice_details_localised_choice_title_shield_ally_region_vik_reg_tintagolFIRST	We must honour the rights of our ally and return this land to their king.	true
cdir_events_dilemma_choice_details_localised_choice_title_shield_ally_region_vik_reg_tintagolSECOND	Our ally will surely be angered by our theft of their land.	true
cdir_events_dilemma_choice_details_localised_choice_title_shield_ally_region_vik_reg_tor_in_duineFIRST	We must honour the rights of our ally and return this land to their king.	true
cdir_events_dilemma_choice_details_localised_choice_title_shield_ally_region_vik_reg_tor_in_duineSECOND	Our ally will surely be angered by our theft of their land.	true
cdir_events_dilemma_choice_details_localised_choice_title_shield_ally_region_vik_reg_torfnessFIRST	We must honour the rights of our ally and return this land to their king.	true
cdir_events_dilemma_choice_details_localised_choice_title_shield_ally_region_vik_reg_torfnessSECOND	Our ally will surely be angered by our theft of their land.	true
cdir_events_dilemma_choice_details_localised_choice_title_shield_ally_region_vik_reg_totanesFIRST	We must honour the rights of our ally and return this land to their king.	true
cdir_events_dilemma_choice_details_localised_choice_title_shield_ally_region_vik_reg_totanesSECOND	Our ally will surely be angered by our theft of their land.	true
cdir_events_dilemma_choice_details_localised_choice_title_shield_ally_region_vik_reg_tuaimFIRST	We must honour the rights of our ally and return this land to their king.	true
cdir_events_dilemma_choice_details_localised_choice_title_shield_ally_region_vik_reg_tuaimSECOND	Our ally will surely be angered by our theft of their land.	true
cdir_events_dilemma_choice_details_localised_choice_title_shield_ally_region_vik_reg_tuam_greineFIRST	We must honour the rights of our ally and return this land to their king.	true
cdir_events_dilemma_choice_details_localised_choice_title_shield_ally_region_vik_reg_tuam_greineSECOND	Our ally will surely be angered by our theft of their land.	true
cdir_events_dilemma_choice_details_localised_choice_title_shield_ally_region_vik_reg_tureceseigFIRST	We must honour the rights of our ally and return this land to their king.	true
cdir_events_dilemma_choice_details_localised_choice_title_shield_ally_region_vik_reg_tureceseigSECOND	Our ally will surely be angered by our theft of their land.	true
cdir_events_dilemma_choice_details_localised_choice_title_shield_ally_region_vik_reg_vedrafjordrFIRST	We must honour the rights of our ally and return this land to their king.	true
cdir_events_dilemma_choice_details_localised_choice_title_shield_ally_region_vik_reg_vedrafjordrSECOND	Our ally will surely be angered by our theft of their land.	true
cdir_events_dilemma_choice_details_localised_choice_title_shield_ally_region_vik_reg_veisafjordrFIRST	We must honour the rights of our ally and return this land to their king.	true
cdir_events_dilemma_choice_details_localised_choice_title_shield_ally_region_vik_reg_veisafjordrSECOND	Our ally will surely be angered by our theft of their land.	true
cdir_events_dilemma_choice_details_localised_choice_title_shield_ally_region_vik_reg_waecetFIRST	We must honour the rights of our ally and return this land to their king.	true
cdir_events_dilemma_choice_details_localised_choice_title_shield_ally_region_vik_reg_waecetSECOND	Our ally will surely be angered by our theft of their land.	true
cdir_events_dilemma_choice_details_localised_choice_title_shield_ally_region_vik_reg_waerincwicumFIRST	We must honour the rights of our ally and return this land to their king.	true
cdir_events_dilemma_choice_details_localised_choice_title_shield_ally_region_vik_reg_waerincwicumSECOND	Our ally will surely be angered by our theft of their land.	true
cdir_events_dilemma_choice_details_localised_choice_title_shield_ally_region_vik_reg_werhamFIRST	We must honour the rights of our ally and return this land to their king.	true
cdir_events_dilemma_choice_details_localised_choice_title_shield_ally_region_vik_reg_werhamSECOND	Our ally will surely be angered by our theft of their land.	true
cdir_events_dilemma_choice_details_localised_choice_title_shield_ally_region_vik_reg_wigingamereFIRST	We must honour the rights of our ally and return this land to their king.	true
cdir_events_dilemma_choice_details_localised_choice_title_shield_ally_region_vik_reg_wigingamereSECOND	Our ally will surely be angered by our theft of their land.	true
cdir_events_dilemma_choice_details_localised_choice_title_shield_ally_region_vik_reg_wigracestreFIRST	We must honour the rights of our ally and return this land to their king.	true
cdir_events_dilemma_choice_details_localised_choice_title_shield_ally_region_vik_reg_wigracestreSECOND	Our ally will surely be angered by our theft of their land.	true
cdir_events_dilemma_choice_details_localised_choice_title_shield_ally_region_vik_reg_wihtFIRST	We must honour the rights of our ally and return this land to their king.	true
cdir_events_dilemma_choice_details_localised_choice_title_shield_ally_region_vik_reg_wihtSECOND	Our ally will surely be angered by our theft of their land.	true
cdir_events_dilemma_choice_details_localised_choice_title_shield_ally_region_vik_reg_wiltunFIRST	We must honour the rights of our ally and return this land to their king.	true
cdir_events_dilemma_choice_details_localised_choice_title_shield_ally_region_vik_reg_wiltunSECOND	Our ally will surely be angered by our theft of their land.	true
cdir_events_dilemma_choice_details_localised_choice_title_shield_ally_region_vik_reg_wintanceasterFIRST	We must honour the rights of our ally and return this land to their king.	true
cdir_events_dilemma_choice_details_localised_choice_title_shield_ally_region_vik_reg_wintanceasterSECOND	Our ally will surely be angered by our theft of their land.	true
cdir_events_dilemma_choice_details_localised_choice_title_shield_ally_region_vik_reg_wyrcesuuyrtheFIRST	We must honour the rights of our ally and return this land to their king.	true
cdir_events_dilemma_choice_details_localised_choice_title_shield_ally_region_vik_reg_wyrcesuuyrtheSECOND	Our ally will surely be angered by our theft of their land.	true
